Cell_Barcode	Sex
AAACCTGAGCAGGTCA	male
AAACCTGAGCCATCGC	male
AAACCTGAGGCATTGG	female
AAACCTGGTATCAGTC	female
AAACCTGGTGACAAAT	female
AAACCTGGTTACCGAT	female
AAACCTGTCAACACAC	male
AAACCTGTCGGATGTT	female
AAACGGGAGTCTTGCA	male
AAACGGGCACCAACCG	female
AAACGGGCATACTCTT	female
AAACGGGTCAGCAACT	male
AAACGGGTCGGTGTCG	male
AAAGATGCACCACGTG	male
AAAGATGCATGACATC	female
AAAGATGGTGCTCTTC	female
AAAGATGGTGTATGGG	male
AAAGATGGTTATCCGA	female
AAAGATGGTTGTCGCG	male
AAAGTAGAGTAGTGCG	female
AAAGTAGCAATAACGA	female
AAAGTAGCACCTGGTG	male
AAAGTAGCAGTGGGAT	male
AAAGTAGTCCAGTATG	male
AAAGTAGTCTATCCCG	female
AAATGCCCACGTCTCT	female
AACACGTCAACGATGG	male
AACACGTCATCCGGGT	male
AACACGTGTTCCACGG	male
AACACGTTCCTACAGA	female
AACCATGCACTTAACG	male
AACCATGGTCGACTAT	female
AACCATGTCACCCGAG	female
AACCATGTCCGCAGTG	male
AACCGCGAGCATGGCA	male
AACCGCGAGCGTAGTG	male
AACCGCGGTCTCTCTG	female
AACCGCGTCAGGTTCA	female
AACGTTGCAATTGCTG	male
AACGTTGGTATAAACG	male
AACGTTGGTCTCAACA	female
AACGTTGGTGTAAGTA	male
AACGTTGGTTCTCATT	female
AACTCAGCAAAGAATC	female
AACTCAGCACCTATCC	male
AACTCAGGTAGAGTGC	male
AACTCCCAGGTGCACA	female
AACTCCCTCACCCGAG	female
AACTCCCTCCTTAATC	male
AACTCTTAGTCATCCA	female
AACTCTTCACCGGAAA	female
AACTCTTGTAAGTTCC	male
AACTCTTGTTATCGGT	female
AACTGGTAGGTGCTTT	female
AACTGGTCACCATCCT	female
AACTGGTTCAACGGGA	female
AACTGGTTCACTCCTG	male
AACTTTCCACGCCAGT	male
AACTTTCTCGTCCAGG	male
AAGACCTGTCCTAGCG	male
AAGACCTGTGCGCTTG	female
AAGACCTGTTCGAATC	female
AAGACCTTCTACTATC	male
AAGCCGCAGAGAGCTC	female
AAGCCGCCAAGAGTCG	female
AAGCCGCGTCTTCAAG	female
AAGCCGCTCTTGCCGT	male
AAGGAGCAGATGGCGT	male
AAGGAGCGTAAGAGAG	female
AAGGAGCTCATATCGG	female
AAGGAGCTCCGGCACA	male
AAGGAGCTCGACGGAA	male
AAGGCAGAGAGGTACC	male
AAGGCAGGTAGGCATG	male
AAGGCAGGTATATGGA	male
AAGGCAGGTTCCAACA	female
AAGGCAGTCTTGCCGT	male
AAGGTTCAGGCACATG	female
AAGGTTCAGGGAGTAA	male
AAGGTTCCACGAAAGC	female
AAGTCTGCACATTTCT	female
AAGTCTGGTATCAGTC	male
AAGTCTGGTGCGAAAC	female
AAGTCTGTCGGCTTGG	female
AAGTCTGTCTATGTGG	male
AATCCAGAGATGTCGG	female
AATCCAGAGGCAAAGA	male
AATCCAGCAGACGCCT	male
AATCCAGCATCTACGA	female
AATCCAGGTCTGATCA	female
AATCGGTAGCAGGCTA	female
AATCGGTAGCTAGTCT	male
AATCGGTCATATGGTC	male
AATCGGTGTTAAGACA	female
AATCGGTGTTATGTGC	female
ACACCAAAGCTAACTC	female
ACACCAACACTGAAGG	male
ACACCAACATCAGTAC	female
ACACCAAGTGGACGAT	female
ACACCAAGTTAAGTAG	female
ACACCAATCGGCCGAT	female
ACACCCTAGCGGATCA	female
ACACCCTTCCAAACAC	female
ACACCCTTCCAGTATG	male
ACACCGGAGGTCATCT	female
ACACTGAAGCTAGTTC	male
ACACTGAAGGATGGTC	male
ACACTGACATGTCTCC	female
ACAGCCGAGCGATGAC	male
ACAGCCGAGTTAGCGG	male
ACAGCCGCACATGACT	male
ACAGCCGGTCAGAGGT	male
ACAGCCGTCCGGGTGT	female
ACAGCTAAGTGTCCAT	female
ACAGCTACAATGGATA	female
ACAGCTAGTATTACCG	female
ACAGCTAGTGACGCCT	female
ACAGCTATCCATTCTA	male
ACAGCTATCCTAAGTG	female
ACATACGAGGGCTTGA	female
ACATACGAGTTTCCTT	female
ACATACGCATTTGCTT	female
ACATACGGTAAAGTCA	male
ACATACGGTGACGGTA	female
ACATACGGTTATGCGT	female
ACATACGTCTTACCTA	male
ACATACGTCTTGTCAT	female
ACATCAGCAAGTTGTC	male
ACATCAGCATCCCATC	male
ACATCAGTCTCGAGTA	male
ACATGGTAGACGACGT	male
ACATGGTCATGCCCGA	male
ACATGGTTCCACGTGG	female
ACATGGTTCCTTTCGG	male
ACATGGTTCGTCGTTC	male
ACATGGTTCTAACTCT	female
ACATGGTTCTATGTGG	male
ACCAGTACAGACACTT	female
ACCAGTATCGGTCTAA	male
ACCCACTAGAGTCGGT	female
ACCCACTAGATGCCAG	male
ACCCACTAGCCAGTAG	male
ACCCACTCATGGGACA	female
ACCCACTGTCTAAACC	male
ACCCACTGTGGAAAGA	male
ACCCACTGTTCCACTC	male
ACCGTAAGTCCTCTTG	female
ACCGTAAGTCGGGTCT	female
ACCGTAATCGCCTGTT	female
ACCTTTAAGAGTAATC	male
ACCTTTACACTTACGA	male
ACCTTTACAGACACTT	female
ACCTTTACATTAGGCT	male
ACGAGCCGTGACCAAG	female
ACGAGCCGTGACGCCT	female
ACGAGCCGTTACAGAA	male
ACGAGCCTCCATTCTA	female
ACGAGCCTCCCTTGCA	female
ACGAGGAAGACAGGCT	male
ACGAGGACAAATACAG	male
ACGAGGACACCGCTAG	male
ACGAGGAGTCATATCG	male
ACGAGGATCAAGGTAA	female
ACGATACAGCCTCGTG	female
ACGATACAGCGATATA	male
ACGATACAGTACGCCC	female
ACGATACCAGATCCAT	female
ACGATACCAGCTATTG	male
ACGATACGTGTAATGA	male
ACGATACGTTGCGTTA	male
ACGATACTCATCACCC	male
ACGATGTAGCACCGTC	female
ACGATGTAGCATGGCA	female
ACGATGTAGCGAGAAA	female
ACGATGTAGGCCCGTT	female
ACGATGTAGGGTCTCC	female
ACGATGTGTATCACCA	male
ACGATGTTCATTTGGG	male
ACGCAGCAGAAACCGC	female
ACGCAGCGTATTACCG	male
ACGCAGCTCCTGCCAT	male
ACGCCAGCATGTAAGA	female
ACGCCGAAGCTGATAA	male
ACGCCGAAGTGCTGCC	male
ACGCCGACAGGAACGT	female
ACGCCGACATTGGCGC	female
ACGCCGAGTCAGAAGC	male
ACGCCGAGTTGAGGTG	female
ACGCCGATCAACGGGA	male
ACGCCGATCCTGCTTG	male
ACGCCGATCTTTAGTC	female
ACGGAGAAGTGAATTG	male
ACGGAGACAACACCCG	female
ACGGAGATCTAGCACA	male
ACGGCCAGTAAAGGAG	female
ACGGCCATCTCCTATA	female
ACGGGCTAGAATTCCC	female
ACGGGCTAGCGATAGC	female
ACGGGCTTCCTCAATT	female
ACGGGTCAGAAGGTGA	female
ACGGGTCAGATGTGGC	male
ACGGGTCCATCGGACC	male
ACGGGTCTCGCATGAT	male
ACGGGTCTCTTGGGTA	female
ACGTCAAAGCACCGTC	female
ACGTCAACACATCTTT	female
ACGTCAACATGAGCGA	male
ACGTCAAGTGTGGCTC	female
ACGTCAAGTTCCCTTG	female
ACGTCAATCATGTCCC	female
ACTATCTAGGGTTCCC	female
ACTATCTAGTGATCGG	male
ACTATCTCAGCATGAG	female
ACTATCTGTCAACTGT	male
ACTGAACAGAGAACAG	female
ACTGAACAGGCGCTCT	female
ACTGAACGTGCTAGCC	male
ACTGAGTGTCGAATCT	male
ACTGAGTTCCTCAATT	female
ACTGATGAGACTAAGT	female
ACTGATGAGGACACCA	female
ACTGATGCAAGCCTAT	male
ACTGATGTCATCATTC	female
ACTGCTCAGCGAGAAA	male
ACTGCTCAGGATGGAA	female
ACTGCTCAGTCAAGGC	male
ACTGCTCCAGCTATTG	female
ACTGCTCTCGCGATCG	female
ACTGTCCAGAGTCTGG	female
ACTGTCCAGGAGCGAG	male
ACTGTCCCACAGTCGC	male
ACTGTCCCAGGGTACA	female
ACTGTCCTCAGGTTCA	male
ACTGTCCTCAGTTCGA	male
ACTTACTAGATAGCAT	female
ACTTACTCAAGACGTG	female
ACTTACTCAATGGATA	male
ACTTACTGTACCGTAT	male
ACTTACTTCCCAAGTA	female
ACTTGTTAGAACTGTA	female
ACTTGTTCACCATCCT	male
ACTTGTTCATTGTGCA	male
ACTTGTTGTCAACATC	female
ACTTTCAAGGCAGTCA	female
ACTTTCAAGTCTTGCA	male
ACTTTCACATGCCTAA	female
ACTTTCAGTGCACTTA	male
ACTTTCATCATGTGGT	female
AGAATAGAGATGTCGG	female
AGAATAGAGCCCAACC	female
AGAATAGAGGCCCGTT	male
AGAATAGCAAGACACG	female
AGAATAGGTAAATACG	male
AGACGTTAGACTGTAA	female
AGACGTTGTGTTTGGT	male
AGACGTTTCCACGTTC	female
AGAGCGAAGACTACAA	female
AGAGCGAAGCTTATCG	female
AGAGCGACAGCTCGAC	male
AGAGCGACATCCTTGC	female
AGAGCGAGTTCCCGAG	female
AGAGCTTTCAAAGTAG	female
AGAGCTTTCAACGAAA	male
AGAGCTTTCCCTTGTG	male
AGAGCTTTCTGCAAGT	female
AGAGTGGAGGTGCAAC	female
AGAGTGGGTTTACTCT	female
AGATCTGAGATAGGAG	female
AGATCTGAGCGATATA	female
AGATCTGAGGTAGCCA	male
AGATCTGCAAAGGCGT	male
AGATCTGCAAGTCATC	male
AGATCTGGTTCGGGCT	female
AGATCTGGTTTGACTG	female
AGATCTGTCAGTTGAC	male
AGATTGCAGCTAGTCT	female
AGATTGCAGTGGTCCC	male
AGATTGCCATGGTCAT	male
AGATTGCGTTCCACAA	female
AGATTGCGTTCCCTTG	female
AGATTGCGTTGTTTGG	male
AGATTGCTCAGAGGTG	male
AGATTGCTCTGCGGCA	female
AGATTGCTCTGCGTAA	male
AGCAGCCGTCATATCG	male
AGCAGCCGTGCAGGTA	female
AGCAGCCTCAACCATG	male
AGCATACAGGTAAACT	male
AGCATACAGTCTCCTC	female
AGCATACAGTGTACCT	male
AGCATACCAGACGCTC	male
AGCATACCATGAGCGA	male
AGCATACGTACTCGCG	male
AGCATACGTCGAGTTT	female
AGCATACTCTACCAGA	female
AGCCTAATCCGAACGC	male
AGCCTAATCGAACTGT	female
AGCCTAATCTCACATT	male
AGCGGTCCAGGTCGTC	female
AGCGGTCGTCGAAAGC	female
AGCGGTCGTGAAATCA	female
AGCGGTCGTTAAGAAC	male
AGCGGTCGTTATGTGC	female
AGCGGTCTCAGTTTGG	female
AGCGGTCTCATGTAGC	female
AGCGGTCTCCCTTGCA	male
AGCGTATGTCCGTTAA	male
AGCGTATGTGAGGGAG	male
AGCGTATGTGTAACGG	female
AGCGTATTCACCCGAG	female
AGCGTATTCAGTTAGC	female
AGCGTATTCCAATGGT	male
AGCGTCGGTTACCGAT	female
AGCGTCGTCGCGGATC	male
AGCTCCTAGCTAACTC	male
AGCTCCTAGTCCATAC	female
AGCTCCTAGTGTGAAT	male
AGCTCCTGTACAGCAG	female
AGCTCCTGTCGTTGTA	female
AGCTCCTGTTGGTAAA	male
AGCTCCTTCGGCTTGG	male
AGCTCCTTCGGTTCGG	female
AGCTCTCAGCATGGCA	male
AGCTCTCAGCTAGTTC	female
AGCTCTCAGTTCGCAT	male
AGCTCTCCAATGGAAT	female
AGCTCTCCACAGACAG	male
AGCTTGAAGTGATCGG	female
AGCTTGACATACTACG	male
AGCTTGAGTGATGCCC	male
AGCTTGAGTGTGAAAT	male
AGCTTGATCCCAGGTG	female
AGCTTGATCGTCGTTC	male
AGCTTGATCTACGAGT	female
AGGCCACGTAAGTTCC	female
AGGCCGTAGATGGGTC	female
AGGCCGTAGCCAGTAG	male
AGGCCGTAGTTACGGG	female
AGGCCGTGTGGCCCTA	male
AGGCCGTTCCCTTGTG	male
AGGGAGTAGATACACA	male
AGGGAGTGTCCAAGTT	male
AGGGAGTGTTAAGAAC	female
AGGGAGTTCTAAGCCA	male
AGGGAGTTCTATCCTA	male
AGGGATGGTCACTTCC	female
AGGGATGTCCACTCCA	female
AGGGATGTCGAGAACG	male
AGGGTGAAGCCACCTG	male
AGGGTGAAGGGCATGT	female
AGGGTGACACGTCTCT	male
AGGGTGAGTACCAGTT	female
AGGTCATAGATATACG	female
AGGTCATAGGATTCGG	female
AGGTCATCAAACTGTC	male
AGGTCATCAATACGCT	male
AGGTCATGTAGCCTCG	male
AGGTCATGTCCGTCAG	female
AGGTCATTCCCTAACC	male
AGGTCATTCTATCCTA	male
AGGTCCGAGAGCAATT	male
AGGTCCGAGCCACGCT	female
AGGTCCGAGGGCTCTC	male
AGGTCCGCATGAAGTA	male
AGGTCCGTCCAGAAGG	male
AGTAGTCCACCGCTAG	female
AGTAGTCCAGTATGCT	male
AGTAGTCGTCCGAACC	female
AGTAGTCGTGGGTCAA	female
AGTAGTCGTTAAAGAC	male
AGTAGTCTCACAAACC	male
AGTCTTTAGTCACGCC	male
AGTCTTTAGTGGGTTG	female
AGTCTTTTCACTCTTA	female
AGTCTTTTCATATCGG	male
AGTGAGGAGCGTAATA	male
AGTGAGGCAACACCTA	male
AGTGAGGCAGGGAGAG	male
AGTGAGGGTAGGCTGA	female
AGTGAGGTCAGCAACT	male
AGTGGGAAGAGAACAG	female
AGTGGGAAGCAACGGT	female
AGTGGGAAGCTAGGCA	male
AGTGGGACAACGATCT	female
AGTGGGACACTGTTAG	female
AGTGGGACATCGGAAG	male
AGTGGGAGTACTTGAC	male
AGTGGGATCCAAACAC	male
AGTGGGATCCAGAGGA	female
AGTGGGATCCTATTCA	female
AGTGTCAAGATAGCAT	female
AGTGTCAGTCCGTCAG	male
AGTGTCATCTGGGCCA	female
AGTTGGTTCACCAGGC	male
ATAACGCGTATAGTAG	male
ATAACGCGTCCTAGCG	female
ATAACGCGTTACCGAT	female
ATAACGCTCTCTGAGA	female
ATAAGAGCACGAAAGC	female
ATAAGAGGTCAAAGCG	female
ATAGACCAGGTGCACA	male
ATAGACCCACGACGAA	female
ATAGACCCACGTCAGC	female
ATAGACCCATCTCGCT	male
ATAGACCGTTCCCGAG	female
ATAGACCTCCACGAAT	male
ATCACGACACAGATTC	female
ATCACGATCAGCCTAA	female
ATCACGATCTTGCAAG	female
ATCATCTAGAAGGTGA	male
ATCATCTAGCTAGGCA	female
ATCATCTAGGGCTTGA	female
ATCATCTAGTGTCTCA	female
ATCATCTCATCCCACT	female
ATCATGGAGGGTGTGT	female
ATCATGGAGTGGAGAA	female
ATCATGGTCGTAGGTT	female
ATCCACCAGCGTTCCG	male
ATCCACCGTCCGAACC	female
ATCCACCGTCCGTGAC	male
ATCCACCGTTGAGTTC	male
ATCCACCTCAGCTCTC	male
ATCCACCTCTACTATC	male
ATCCACCTCTTGTTTG	female
ATCCGAAAGCTGGAAC	female
ATCCGAAAGTGGAGAA	male
ATCCGAACATCTGGTA	female
ATCCGAAGTAGCTCCG	male
ATCCGAAGTGTGAAAT	female
ATCGAGTGTCTTCTCG	male
ATCGAGTTCTTGACGA	male
ATCTACTAGACCGGAT	female
ATCTACTAGCTAAGAT	female
ATCTACTCACTACAGT	male
ATCTACTGTGAGGGAG	male
ATCTACTGTGATGTGG	male
ATCTACTTCAGTCAGT	male
ATCTACTTCGAATCCA	female
ATCTGCCAGCGTGAAC	female
ATCTGCCCAATAGCAA	male
ATCTGCCCACACCGAC	female
ATCTGCCCAGCTGGCT	female
ATCTGCCGTCTAGCGC	female
ATCTGCCTCACCCTCA	male
ATCTGCCTCGTACGGC	female
ATGAGGGAGACATAAC	male
ATGAGGGCACCAGCAC	male
ATGAGGGCACCCTATC	female
ATGAGGGCACTTACGA	female
ATGAGGGCAGGACCCT	female
ATGAGGGCATAAAGGT	male
ATGAGGGGTTCGTGAT	female
ATGAGGGTCTTCGGTC	male
ATGCGATAGATCCCAT	female
ATGCGATCAGCTGTTA	female
ATGCGATGTAGCGTCC	female
ATGCGATGTGCTCTTC	female
ATGCGATGTTCTGTTT	female
ATGCGATTCTCCTATA	female
ATGGGAGAGACGCACA	female
ATGGGAGAGTCCCACG	female
ATGGGAGCATTTCAGG	male
ATGTGTGAGCGTTGCC	male
ATGTGTGTCCAAGTAC	female
ATTACTCAGCGTGAGT	female
ATTACTCTCGGCGCAT	male
ATTATCCAGGTTCCTA	female
ATTATCCAGTCAATAG	male
ATTATCCAGTTTCCTT	male
ATTATCCCATAGACTC	male
ATTATCCGTCGAATCT	female
ATTCTACAGATATACG	female
ATTCTACAGCAAATCA	male
ATTCTACCATAAAGGT	female
ATTGGACAGCGCTCCA	male
ATTGGACTCCGTAGGC	female
ATTGGTGAGGCGATAC	female
ATTGGTGAGGCTCAGA	male
ATTGGTGCAAGCGTAG	male
ATTGGTGGTTGGAGGT	female
ATTGGTGTCCCTAATT	female
ATTGGTGTCCTTTCGG	female
ATTTCTGAGCGGATCA	female
ATTTCTGCAAGTTAAG	female
ATTTCTGGTCGGGTCT	female
ATTTCTGTCCCTTGTG	female
CAACCAAAGGGTTTCT	female
CAACCAACACGCATCG	female
CAACCAAGTATAGTAG	female
CAACCAATCACTTACT	female
CAACCAATCGGATGTT	male
CAACCAATCTTGAGAC	female
CAACCTCCACATGACT	male
CAACCTCGTCCGTTAA	female
CAACCTCGTCTTCGTC	female
CAACTAGAGTCGTACT	female
CAACTAGCAGGGTATG	male
CAACTAGGTCCATGAT	female
CAACTAGGTGAGTGAC	female
CAACTAGTCTTGTCAT	female
CAAGAAAAGAAACGCC	female
CAAGAAAAGACTGTAA	male
CAAGAAAAGTAGGCCA	female
CAAGAAACATATACCG	female
CAAGATCAGAAACGCC	female
CAAGATCCAGCGATCC	female
CAAGATCCAGTTTACG	female
CAAGATCGTTCAGACT	female
CAAGATCTCCTTGACC	female
CAAGGCCAGTTGTAGA	male
CAAGGCCCAAGTCATC	male
CAAGGCCGTGGTACAG	female
CAAGTTGAGTAGCCGA	female
CAAGTTGAGTTTGCGT	male
CAAGTTGCACGGTTTA	female
CACAAACAGGTAGCTG	male
CACAAACAGTGCAAGC	female
CACAAACCAGTCGTGC	female
CACAAACGTAGCGTAG	female
CACAAACGTCTTCAAG	female
CACAAACTCCACGTTC	female
CACAAACTCCCTCTTT	male
CACAAACTCTGCGTAA	male
CACACAACATAGGATA	male
CACACAATCAGTGTTG	female
CACACAATCGCGGATC	female
CACACCTAGGTCGGAT	female
CACACCTCACCTCGGA	female
CACACCTGTACTTCTT	male
CACACCTGTGTTGGGA	male
CACACTCAGCCACGTC	female
CACACTCCATCGGGTC	female
CACAGGCAGACATAAC	female
CACAGGCCACAGTCGC	female
CACAGGCCAGTCACTA	female
CACAGGCCATCGGGTC	male
CACAGGCGTGTTAAGA	male
CACAGGCGTGTTCTTT	female
CACAGGCTCAGTTAGC	female
CACAGGCTCCTCAATT	male
CACAGTAAGTTCGATC	female
CACAGTACATCCAACA	male
CACAGTAGTCTCACCT	male
CACAGTAGTTTGACAC	female
CACAGTATCCCTTGCA	female
CACATAGAGAGCTTCT	male
CACATAGAGTCCGGTC	male
CACATAGAGTTACCCA	female
CACATAGGTCTTGCGG	male
CACATTTAGACGCAAC	male
CACATTTAGTACTTGC	male
CACATTTCAACTGCTA	female
CACATTTTCCACGAAT	female
CACCACTAGCACCGCT	female
CACCACTAGCCAGGAT	male
CACCACTAGGTGCTTT	female
CACCACTCACAGGTTT	female
CACCACTGTGGTTTCA	female
CACCACTTCGCAAACT	female
CACCTTGAGCCCGAAA	male
CACCTTGAGCGTTGCC	male
CACCTTGGTTGGGACA	female
CACTCCAGTGCGATAG	male
CACTCCATCGACAGCC	female
CACTCCATCGTGGTCG	female
CAGAATCCACCGATAT	female
CAGAATCCAGGTGCCT	male
CAGAATCTCCATTCTA	male
CAGAATCTCGCGGATC	female
CAGAGAGAGATGGGTC	female
CAGAGAGAGTGTACGG	female
CAGAGAGAGTTGTCGT	male
CAGAGAGCAGTATGCT	female
CAGAGAGGTCTCCATC	male
CAGAGAGTCCCTAACC	female
CAGAGAGTCCGTAGTA	male
CAGAGAGTCGTGACAT	female
CAGATCAAGCACAGGT	male
CAGATCAAGTCGTTTG	female
CAGATCACAGATGGCA	male
CAGATCAGTCCAGTTA	male
CAGATCAGTGTGTGCC	female
CAGATCATCCAAGCCG	male
CAGCAGCAGTCACGCC	female
CAGCAGCCAGGAACGT	female
CAGCAGCTCGTTGCCT	female
CAGCATAAGAGTCGGT	male
CAGCATAAGCAAATCA	male
CAGCATAAGTGTGAAT	male
CAGCATACAGGTGGAT	male
CAGCATAGTCGCATAT	female
CAGCATATCCCTAACC	female
CAGCATATCTAGAGTC	female
CAGCCGACACTCGACG	female
CAGCCGAGTCAAGCGA	male
CAGCCGAGTGCATCTA	male
CAGCCGATCGGAGGTA	male
CAGCGACCAGATCCAT	female
CAGCGACGTCATACTG	female
CAGCGACTCTCGCTTG	female
CAGCGACTCTTGGGTA	female
CAGCTAACACACTGCG	female
CAGCTAACATGAGCGA	male
CAGCTAAGTCGGCTCA	female
CAGCTAAGTGATAAGT	male
CAGCTGGAGAGTACAT	male
CAGCTGGGTGGCCCTA	male
CAGCTGGTCATTTGGG	female
CAGGTGCAGGTGGGTT	female
CAGGTGCCAATCTGCA	female
CAGGTGCGTCAACTGT	male
CAGGTGCGTCTCAACA	female
CAGGTGCTCTCCCTGA	male
CAGTAACCAATAAGCA	male
CAGTAACCACGTCTCT	male
CAGTAACTCTGATTCT	female
CAGTCCTAGACATAAC	female
CAGTCCTCAACACCCG	female
CAGTCCTGTCACTTCC	female
CATATGGAGTGGAGAA	male
CATATGGCATCGTCGG	female
CATATGGGTGTGAATA	male
CATATGGTCCTCATTA	female
CATATTCAGAGGTACC	female
CATATTCCACGAGGTA	female
CATATTCCAGTCAGAG	male
CATATTCCAGTTAACC	female
CATATTCCATCGGGTC	male
CATATTCTCATAAAGG	female
CATCAAGAGAAACCAT	male
CATCAAGAGAAACCGC	male
CATCAAGAGCCACTAT	female
CATCAAGCACGTTGGC	female
CATCAAGCAGACTCGC	female
CATCAAGGTCAGATAA	male
CATCAAGGTTAGTGGG	male
CATCAAGTCTGGAGCC	male
CATCAGAAGCAGGCTA	male
CATCAGACAATCGAAA	female
CATCAGAGTAGCTGCC	male
CATCAGATCACCAGGC	female
CATCAGATCCTTGGTC	female
CATCCACAGGCAGGTT	female
CATCCACAGGCGCTCT	male
CATCCACTCGAATGCT	female
CATCCACTCGAATGGG	female
CATCCACTCTCCAGGG	male
CATCGAACAAGCCATT	female
CATCGAACACGGATAG	female
CATCGAATCTGGTATG	male
CATCGAATCTTGAGAC	male
CATCGAATCTTGGGTA	female
CATCGGGAGACCTAGG	female
CATCGGGAGCCACGCT	female
CATCGGGCAAATCCGT	male
CATCGGGGTCGAAAGC	male
CATCGGGGTGCTGTAT	female
CATCGGGTCACCAGGC	male
CATCGGGTCCCTCTTT	male
CATGACACACCTCGGA	male
CATGACAGTCGCATCG	male
CATGACATCGGTTCGG	male
CATGCCTCAGCGTCCA	female
CATGCCTCAGGGTACA	female
CATGCCTCATACTCTT	female
CATGCCTGTTCGGCAC	female
CATGGCGTCACCTTAT	male
CATTATCAGCAGCCTC	female
CATTATCAGGTGCTTT	male
CATTATCAGTGGTAAT	female
CATTATCCAAGTTGTC	male
CATTATCTCCTCTAGC	female
CATTCGCAGCGATATA	female
CATTCGCAGCGTAGTG	male
CATTCGCAGCTGATAA	male
CATTCGCGTTAAAGAC	male
CATTCGCTCCGGGTGT	male
CCAATCCGTCCCGACA	male
CCAATCCTCGTCCAGG	female
CCACCTAAGACTACAA	female
CCACCTAAGCACCGTC	female
CCACCTAAGCTGATAA	female
CCACCTAAGGCTAGAC	female
CCACCTAAGGTAAACT	female
CCACCTACAAGGGTCA	male
CCACCTACATACTACG	female
CCACCTATCTAGAGTC	male
CCACCTATCTGCTGTC	male
CCACGGAAGGACATTA	male
CCACGGAAGTCCGTAT	male
CCACGGACAATGTTGC	female
CCACGGAGTCCATCCT	female
CCACGGATCGGAATCT	female
CCACGGATCTTGACGA	male
CCACTACAGCCTATGT	female
CCACTACAGTATTGGA	female
CCACTACCAAGCGCTC	male
CCACTACCATTCACTT	male
CCACTACGTCCAGTAT	female
CCACTACTCCGTAGGC	female
CCACTACTCTTACCTA	male
CCAGCGAAGACCTTTG	female
CCAGCGACACAGGAGT	male
CCAGCGAGTCCGAACC	female
CCAGCGAGTTGGACCC	male
CCATGTCAGTACACCT	male
CCATGTCCATACCATG	female
CCATGTCGTTGTTTGG	female
CCATTCGAGAACAATC	female
CCATTCGAGCTCTCGG	female
CCATTCGAGTTGCAGG	female
CCATTCGGTATTAGCC	female
CCATTCGTCAAGGTAA	female
CCATTCGTCATGCAAC	male
CCATTCGTCATTGCGA	male
CCATTCGTCCAACCAA	female
CCATTCGTCCGCATAA	female
CCCAATCAGTGCCAGA	male
CCCAATCCAGCGTAAG	female
CCCAATCCATGGAATA	male
CCCAATCCATTCCTGC	female
CCCAATCGTGTCAATC	female
CCCAATCTCCCATTAT	male
CCCAATCTCGCACTCT	female
CCCAGTTAGAAGAAGC	female
CCCAGTTCACATCCGG	male
CCCAGTTCATGCCCGA	female
CCCAGTTTCCGTACAA	female
CCCATACAGCATCATC	female
CCCATACCAATCTACG	female
CCCATACGTCATCCCT	male
CCCATACTCACTCCTG	male
CCCATACTCTCTAAGG	male
CCCTCCTAGCGATAGC	female
CCCTCCTCACCGATAT	female
CCCTCCTGTAAGAGAG	male
CCCTCCTTCACAAACC	male
CCCTCCTTCTATGTGG	female
CCCTCCTTCTTGTTTG	male
CCGGGATAGGCTCTTA	female
CCGGGATAGTCTCGGC	female
CCGGGATGTATAGTAG	female
CCGGGATGTCAACTGT	female
CCGGGATGTGCCTGTG	male
CCGGGATTCCAGTATG	female
CCGGGATTCGCCGTGA	male
CCGGGATTCGGATGGA	female
CCGGTAGAGCTACCTA	male
CCGGTAGCAAGACACG	female
CCGGTAGGTGCAGTAG	female
CCGGTAGTCACAGGCC	female
CCGTACTCAAGCCTAT	female
CCGTACTCAGCTGGCT	male
CCGTACTCATCCCACT	male
CCGTACTGTCGGATCC	female
CCGTACTGTGTGGTTT	female
CCGTACTTCGATAGAA	male
CCGTACTTCTCCCTGA	male
CCGTGGACAGCGTTCG	female
CCGTGGAGTCGAATCT	male
CCGTGGATCTAACCGA	male
CCGTTCAAGAGACTTA	female
CCGTTCAAGGCATTGG	female
CCGTTCAGTCAATACC	female
CCGTTCAGTCGCTTTC	female
CCGTTCATCTGAGTGT	male
CCTAAAGCAAGTCTAC	male
CCTACACAGCGCCTTG	female
CCTACACAGTCCTCCT	male
CCTACACCAGATCCAT	male
CCTACACTCGCAAGCC	female
CCTACACTCGTCTGCT	female
CCTACCAAGATGTGGC	male
CCTACCACAAAGAATC	female
CCTACCACAGCATACT	female
CCTACCACAGGCTCAC	female
CCTACCAGTGGACGAT	male
CCTACCAGTTTACTCT	female
CCTACCATCTGTTTGT	female
CCTAGCTAGACTCGGA	male
CCTAGCTAGAGGTAGA	male
CCTAGCTAGGATGCGT	female
CCTAGCTCAGACGCAA	male
CCTAGCTCAGACGTAG	female
CCTATTAAGGCGTACA	female
CCTATTAAGTAGCGGT	female
CCTATTAGTCCAAGTT	female
CCTATTAGTGTTTGTG	male
CCTCAGTAGCCACGTC	female
CCTCAGTAGGAGTCTG	male
CCTCAGTGTCCTAGCG	male
CCTCAGTGTGGTCTCG	male
CCTCAGTGTTCACCTC	female
CCTCAGTTCGGATGTT	female
CCTCTGACAAGAGTCG	male
CCTCTGAGTAATCGTC	female
CCTCTGAGTCCTAGCG	male
CCTCTGAGTGTAATGA	female
CCTCTGAGTGTCGCTG	female
CCTCTGATCAGGCCCA	female
CCTCTGATCGCCCTTA	female
CCTTACGTCAGTTGAC	female
CCTTACGTCGGATGGA	female
CCTTCCCCAGAAGCAC	female
CCTTCCCCATCACAAC	female
CCTTCCCTCGCGATCG	male
CCTTCCCTCTACCAGA	female
CCTTCGAAGAATTCCC	male
CCTTCGACAGCCAATT	female
CCTTCGAGTCTCCATC	female
CCTTCGATCTCAACTT	female
CCTTTCTAGTTCGCGC	male
CCTTTCTGTCCGACGT	female
CCTTTCTTCCAAAGTC	female
CGAACATCAATGCCAT	female
CGAACATCACCAGCAC	female
CGAACATCATGGGAAC	female
CGAACATGTAAGAGGA	male
CGAACATGTTCCCTTG	male
CGAACATTCAAGGTAA	male
CGAATGTAGGACCACA	male
CGAATGTAGTAGTGCG	female
CGAATGTGTACTTGAC	female
CGAATGTGTTTGGCGC	male
CGAATGTTCTGACCTC	female
CGACCTTAGAGTACCG	female
CGACCTTAGTACTTGC	female
CGACCTTAGTGCGATG	female
CGACCTTCACCTCGTT	female
CGACCTTGTAGCGATG	female
CGACCTTGTCTCCATC	male
CGACCTTGTGGCTCCA	female
CGACTTCCAAAGTGCG	male
CGACTTCGTACCCAAT	female
CGACTTCGTGAGTATA	female
CGACTTCGTTCGTGAT	female
CGACTTCTCGTTACGA	female
CGAGAAGCAGACTCGC	male
CGAGAAGGTTACAGAA	female
CGAGCACAGCGGCTTC	female
CGAGCACCAACTGCTA	female
CGAGCACCAGCTGTTA	female
CGAGCACTCAAAGACA	female
CGAGCCAAGGGATGGG	female
CGAGCCACAGTCGTGC	female
CGAGCCACATCCCATC	male
CGAGCCACATTCCTCG	male
CGATCGGAGATGTAAC	female
CGATCGGAGCTAAGAT	female
CGATCGGAGGCCATAG	female
CGATCGGAGTCTCAAC	female
CGATCGGCATTGAGCT	female
CGATCGGGTAGAGGAA	female
CGATCGGGTCATGCAT	male
CGATCGGGTTGGTGGA	male
CGATCGGTCATACGGT	male
CGATGGCAGATCCTGT	female
CGATGGCAGGTGCTAG	male
CGATGGCCACGGATAG	female
CGATGTAAGACTTGAA	male
CGATGTAAGCAGATCG	female
CGATGTAAGCTGTCTA	female
CGATGTACAACCGCCA	male
CGATGTACACGAAACG	female
CGATGTACACGAGAGT	female
CGATGTACAGGGATTG	male
CGATGTAGTTAGAACA	female
CGATGTATCAAGATCC	male
CGATGTATCTAACGGT	female
CGATGTATCTCTGAGA	female
CGATTGAAGCTTCGCG	female
CGATTGACATTCGACA	male
CGATTGAGTGAACCTT	female
CGCCAAGAGAGAGCTC	female
CGCCAAGAGCTAAGAT	female
CGCCAAGAGGACCACA	female
CGCCAAGAGGCCGAAT	female
CGCCAAGAGGTAAACT	male
CGCCAAGAGTCCTCCT	male
CGCCAAGCACCAGATT	female
CGCCAAGTCGTTGCCT	male
CGCGGTAAGTAATCCC	male
CGCGGTAAGTACGCCC	female
CGCGGTAGTCCTGCTT	female
CGCGGTATCATGCTCC	male
CGCGTTTCACAGGCCT	female
CGCGTTTCAGCTTCGG	female
CGCGTTTGTCGCATAT	male
CGCGTTTGTGTGACCC	female
CGCGTTTGTTCAGGCC	male
CGCGTTTTCCCAGGTG	male
CGCTATCCAAGTTCTG	female
CGCTATCCACGAGGTA	female
CGCTATCCATTGAGCT	female
CGCTATCGTAACGACG	male
CGCTATCGTCGAACAG	male
CGCTATCTCTGTCCGT	male
CGCTGGAAGGGCATGT	female
CGCTGGACAAGGTTTC	male
CGCTGGAGTACGCACC	male
CGCTGGATCAGAGCTT	female
CGCTGGATCGTACGGC	male
CGCTGGATCTAACTCT	female
CGCTTCACAAGCTGAG	female
CGCTTCACAAGGACTG	female
CGCTTCAGTAGGACAC	female
CGCTTCATCATATCGG	female
CGCTTCATCGGAATCT	female
CGGACACAGGCTACGA	male
CGGACACCACTACAGT	male
CGGACACTCGTTTGCC	male
CGGACGTAGCACGCCT	male
CGGACGTCAAGCGATG	female
CGGACGTCATCCGGGT	male
CGGACGTTCACGAAGG	female
CGGACGTTCTTGCCGT	male
CGGACTGCATGTCTCC	male
CGGACTGTCCCACTTG	female
CGGACTGTCTTAACCT	female
CGGAGCTAGTGATCGG	female
CGGAGCTGTAGGGTAC	female
CGGAGCTGTGCCTGCA	female
CGGAGCTGTGGCTCCA	male
CGGAGCTGTGTTCGAT	male
CGGAGTCAGTTCGCGC	female
CGGAGTCCACTTCTGC	male
CGGAGTCCATACAGCT	female
CGGAGTCCATTCCTCG	female
CGGAGTCTCTGCTGTC	male
CGGCTAGAGCTAGTGG	male
CGGCTAGCACACTGCG	female
CGGCTAGCACATAACC	female
CGGCTAGCACTCAGGC	female
CGGCTAGGTTATTCTC	female
CGGCTAGTCGCAGGCT	male
CGGCTAGTCGGTTCGG	female
CGGGTCACACTTAAGC	female
CGGGTCAGTCACCCAG	female
CGGGTCAGTTAAAGAC	female
CGGGTCATCGAATCCA	male
CGGTTAAAGCATGGCA	female
CGGTTAAAGTACGTAA	male
CGGTTAAGTCGACTAT	female
CGGTTAAGTCTGATTG	female
CGGTTAAGTGCGGTAA	female
CGGTTAATCCTTGGTC	female
CGTAGCGAGAGACTTA	male
CGTAGCGAGGATGCGT	female
CGTAGCGAGGATGGAA	male
CGTAGCGCAAGCGTAG	female
CGTAGCGGTAGGCATG	female
CGTAGCGGTCGAACAG	male
CGTAGCGGTGATGTGG	female
CGTAGCGTCAGCTCTC	male
CGTAGCGTCTACTTAC	male
CGTAGGCAGAAGAAGC	female
CGTAGGCCAGGGTTAG	male
CGTAGGCGTAGCACGA	male
CGTAGGCGTTAAGACA	female
CGTCACTAGAGGGATA	female
CGTCACTAGATGTTAG	male
CGTCACTAGTGGACGT	female
CGTCAGGAGCCACGTC	male
CGTCAGGCACCGGAAA	male
CGTCAGGGTCAGAAGC	female
CGTCAGGGTTCCGTCT	female
CGTCAGGTCATGCAAC	male
CGTCAGGTCTACCAGA	female
CGTCCATAGAACAACT	female
CGTCCATCACGTCAGC	female
CGTCCATCAGGCTCAC	male
CGTCCATGTCTCTTTA	male
CGTCCATGTTACAGAA	male
CGTCCATTCACTTCAT	female
CGTCCATTCATCGATG	male
CGTCCATTCGGCCGAT	female
CGTCTACAGCTCCCAG	female
CGTCTACCATGGTCTA	female
CGTCTACGTGGTCTCG	male
CGTCTACTCGTATCAG	male
CGTGAGCCATCACCCT	female
CGTGAGCCATCGGTTA	female
CGTGAGCGTAAAGGAG	male
CGTGAGCGTACAAGTA	male
CGTGTAAAGTACCGGA	female
CGTGTAAAGTACGTTC	male
CGTGTAACACCCATTC	female
CGTGTAACACGAAATA	male
CGTGTAACACTAGTAC	female
CGTGTAATCAAAGTAG	female
CGTGTCTAGTGATCGG	male
CGTGTCTTCCCTAATT	male
CGTTAGACACGTCTCT	male
CGTTAGACATGTCGAT	male
CGTTAGAGTGTATGGG	female
CGTTAGATCCCTTGCA	male
CGTTCTGCAAGCCGCT	male
CGTTCTGCAAGTACCT	female
CGTTCTGGTACGCTGC	male
CGTTCTGTCGGTCCGA	female
CGTTCTGTCTGTGCAA	male
CGTTGGGGTTCTGGTA	female
CGTTGGGTCCCTAACC	male
CTAACTTAGATGTAAC	female
CTAACTTCAAGAGTCG	female
CTAACTTCAGTCGATT	male
CTAACTTGTAGATTAG	female
CTAACTTGTGCTGTAT	female
CTAAGACAGCTATGCT	male
CTAAGACAGGCTATCT	male
CTAAGACAGTTGAGTA	male
CTAAGACCAACGATGG	male
CTAAGACTCCTAGTGA	male
CTAAGACTCGCTTGTC	male
CTAAGACTCTGTCAAG	male
CTAATGGAGAGCTATA	male
CTAATGGAGCAATATG	female
CTAATGGAGTGGCACA	male
CTAATGGCAAGCGAGT	male
CTAATGGCATGAACCT	female
CTACACCAGCCCTAAT	male
CTACACCAGCGATATA	female
CTACACCCACCTCGTT	female
CTACACCCATGGGACA	female
CTACACCGTGCGAAAC	female
CTACATTCAAGCGATG	female
CTACATTCAGACGCCT	male
CTACATTTCCGCATCT	male
CTACATTTCTCGGACG	female
CTACCCAAGACAGGCT	male
CTACCCACAGCCTATA	male
CTACCCAGTTGAGGTG	female
CTACCCAGTTGCCTCT	female
CTACGTCAGCTAAGAT	male
CTACGTCCAGACAGGT	female
CTACGTCCATAGTAAG	male
CTACGTCTCTCCGGTT	male
CTAGAGTGTCCGTTAA	female
CTAGAGTGTCTAGCGC	male
CTAGAGTTCCGGCACA	male
CTAGAGTTCGGTGTTA	female
CTAGCCTAGACGCTTT	male
CTAGCCTAGTACGTTC	female
CTAGCCTCAAACTGCT	female
CTAGCCTCAAATACAG	male
CTAGCCTCATGTAAGA	female
CTAGCCTGTAAATGTG	male
CTAGCCTGTCTGGAGA	male
CTAGCCTGTGATAAGT	female
CTAGCCTGTGGAAAGA	female
CTAGCCTGTTACAGAA	female
CTAGCCTGTTTGTTGG	female
CTAGTGAAGAGTACAT	male
CTAGTGAAGCCAGTTT	female
CTAGTGACAACTGGCC	male
CTAGTGACACAAGTAA	male
CTAGTGAGTTCGTGAT	male
CTAGTGATCATATCGG	male
CTAGTGATCTGGAGCC	male
CTCACACGTATCGCAT	male
CTCACACGTCTAGCCG	female
CTCACACTCTATCGCC	male
CTCAGAACATCACCCT	female
CTCAGAACATTGGCGC	male
CTCAGAAGTAGTACCT	male
CTCAGAAGTCAAACTC	male
CTCAGAATCACCAGGC	male
CTCAGAATCAGCGACC	female
CTCAGAATCGGCTTGG	male
CTCAGAATCTAACTCT	female
CTCATTACAATGCCAT	male
CTCATTACACAGAGGT	female
CTCATTACATCACGTA	female
CTCATTAGTCTGGAGA	male
CTCATTATCCTCTAGC	male
CTCATTATCGTAGGTT	female
CTCATTATCGTTTAGG	female
CTCCTAGTCCTCCTAG	female
CTCCTAGTCGCCAAAT	female
CTCGAAAAGTGAAGTT	male
CTCGAAAGTAACGCGA	female
CTCGAAAGTTGAGGTG	female
CTCGAAATCACCACCT	male
CTCGAAATCACTATTC	female
CTCGAGGAGGCATTGG	male
CTCGAGGCAAGTCTGT	male
CTCGAGGCAGACAAAT	female
CTCGAGGCATCTATGG	female
CTCGAGGCATGCGCAC	female
CTCGAGGTCAAGCCTA	female
CTCGGAGGTTCGGGCT	female
CTCGGAGTCTGTACGA	female
CTCGGGACAAGTCATC	male
CTCGGGAGTTCCCGAG	female
CTCGGGAGTTTAGCTG	male
CTCGGGATCCTGCAGG	female
CTCGGGATCTCGGACG	female
CTCGTACAGGTAGCTG	male
CTCGTACTCTGAGTGT	male
CTCGTCAAGATGCGAC	female
CTCGTCAGTGTGAATA	male
CTCGTCAGTTGGACCC	male
CTCGTCATCTAACTGG	female
CTCTAATAGTTCGCGC	female
CTCTAATCAATAAGCA	female
CTCTAATCAGTTCATG	female
CTCTAATGTAGCTTGT	female
CTCTAATTCGAACTGT	female
CTCTACGCATGGTCAT	male
CTCTACGCATGTTGAC	female
CTCTACGGTCACTGGC	female
CTCTACGGTCATATCG	male
CTCTACGGTTGAGTTC	female
CTCTACGTCACGAAGG	male
CTCTACGTCCTCATTA	male
CTCTGGTTCGCTTAGA	female
CTGAAACAGATCCCGC	female
CTGAAACAGGACGAAA	male
CTGAAACCACATCCGG	female
CTGAAACGTTCTCATT	male
CTGAAACTCTGCTTGC	male
CTGAAGTAGCCCTAAT	female
CTGAAGTCACGGCCAT	female
CTGATAGAGGGTGTGT	female
CTGATAGAGTTATCGC	male
CTGATAGCACGGTGTC	female
CTGATAGCAGTTTACG	female
CTGATAGCATCTGGTA	male
CTGATAGGTGGGTATG	female
CTGATAGTCAAGGCTT	female
CTGATAGTCGTGACAT	male
CTGATCCAGACAGAGA	male
CTGATCCAGACTGGGT	male
CTGATCCAGCGCTTAT	female
CTGCCTACAAGCTGGA	male
CTGCCTACATGCCTTC	male
CTGCCTACATTCTCAT	male
CTGCCTATCACTTATC	male
CTGCGGACAATGACCT	male
CTGCGGACACGGCCAT	male
CTGCGGACAGGATCGA	female
CTGCGGAGTTCAGACT	female
CTGCGGATCCTTAATC	male
CTGCTGTAGATAGTCA	male
CTGCTGTAGGACTGGT	female
CTGCTGTGTGCTCTTC	male
CTGGTCTAGGGTGTTG	female
CTGGTCTGTATTACCG	female
CTGGTCTGTGCCTGCA	female
CTGGTCTTCAACACCA	female
CTGTGCTGTTAGTGGG	male
CTGTTTAGTTAAGAAC	female
CTGTTTAGTTCGGCAC	female
CTTAACTAGAAACGAG	female
CTTAACTAGCATCATC	female
CTTAACTAGTGTGAAT	female
CTTAACTGTTTGTTGG	female
CTTAACTTCCGCTGTT	female
CTTACCGAGCTACCGC	female
CTTACCGAGGTACTCT	female
CTTACCGAGTGCCATT	female
CTTACCGAGTGCGTGA	female
CTTACCGCAAAGGTGC	female
CTTACCGCACGTAAGG	female
CTTACCGGTCGCGTGT	female
CTTACCGTCAACTCTT	female
CTTACCGTCTTACCGC	female
CTTAGGACAAGGGTCA	male
CTTAGGACACGGACAA	male
CTTAGGAGTAGGAGTC	male
CTTAGGAGTGTTCGAT	male
CTTCTCTGTGTGGTTT	female
CTTCTCTTCAGTTTGG	female
CTTCTCTTCCTAGTGA	female
CTTCTCTTCGGAATCT	female
CTTGGCTAGGATGGAA	male
CTTGGCTAGTACGATA	male
CTTGGCTCAAGCCATT	male
CTTGGCTCAGCAGTTT	female
CTTGGCTCATTAGGCT	male
CTTGGCTTCAGCACAT	female
CTTTGCGAGGGCTTGA	male
CTTTGCGCAGGTCCAC	male
CTTTGCGCAGGTGCCT	female
CTTTGCGCATGTCCTC	male
CTTTGCGGTAGCGCAA	female
CTTTGCGGTTAAGATG	male
GAAACTCAGAAGGTGA	male
GAAACTCCAAAGCGGT	male
GAAACTCCAAGCGAGT	female
GAAACTCCAGCTTAAC	female
GAAACTCTCTCGTTTA	female
GAAATGACAACGATGG	female
GAAATGACAATTGCTG	male
GAAATGACACGAAAGC	female
GAAATGACATCCTTGC	female
GAAATGATCCCAGGTG	female
GAACATCAGTTGCAGG	female
GAACATCTCCGAATGT	female
GAACATCTCTACTATC	male
GAACATCTCTGTGCAA	male
GAACCTAAGTTAGCGG	male
GAACCTACAGACGCTC	female
GAACCTATCGCATGGC	male
GAACGGAAGAGCTATA	female
GAACGGAAGTGCCATT	male
GAACGGAGTACCGAGA	male
GAACGGAGTGGCCCTA	female
GAACGGATCCAGAGGA	female
GAACGGATCCTATTCA	male
GAAGCAGCACTCGACG	female
GAATAAGAGCAGGTCA	female
GAATAAGAGTGGGATC	female
GAATAAGCACGAAATA	female
GAATAAGCAGTCAGCC	female
GAATAAGTCAGCCTAA	female
GAATAAGTCGGCGGTT	female
GAATGAAAGATCCCGC	male
GAATGAACAAGCCGCT	female
GAATGAAGTGTGGTTT	male
GACACGCAGTAGTGCG	male
GACACGCCAGACTCGC	male
GACACGCGTTCCGTCT	female
GACACGCTCAGCCTAA	male
GACAGAGAGCTAACAA	male
GACAGAGAGGATATAC	female
GACAGAGTCACTCCTG	female
GACCAATAGACTTTCG	female
GACCAATAGAGCTTCT	male
GACCAATAGATCCCAT	female
GACCAATTCTCTTGAT	female
GACCAATTCTGAGTGT	female
GACCTGGAGCGTCAAG	female
GACCTGGCAGACTCGC	male
GACCTGGTCACAAACC	female
GACCTGGTCGTAGGTT	male
GACGCGTAGGCTCAGA	male
GACGCGTAGGCTCATT	female
GACGCGTCAGACGCTC	male
GACGCGTCAGAGCCAA	female
GACGCGTCATGCCTAA	female
GACGCGTTCACCCTCA	female
GACGCGTTCGACAGCC	male
GACGCGTTCTCGTATT	female
GACGGCTAGCCAACAG	female
GACGGCTAGCTGTCTA	male
GACGGCTAGTTACCCA	male
GACGGCTCAGGTTTCA	female
GACGGCTCATGACATC	male
GACGGCTGTCCCGACA	male
GACGGCTGTGTGAAAT	female
GACGTGCAGGAGTCTG	male
GACGTGCCATCTGGTA	female
GACGTGCGTTCGAATC	male
GACGTTAAGGACGAAA	female
GACGTTAAGTCACGCC	male
GACGTTACAATGTAAG	male
GACGTTAGTGCCTTGG	male
GACGTTAGTTCCACGG	female
GACGTTATCTGTCTAT	female
GACTAACAGGAGTACC	male
GACTAACCATTGGCGC	male
GACTAACGTTATCGGT	female
GACTAACTCCTACAGA	female
GACTACAAGTGGTAGC	male
GACTACACATTGTGCA	female
GACTGCGTCTTATCTG	female
GAGCAGACATGCAATC	male
GAGGTGAAGCAAATCA	male
GAGGTGAAGGGCTTCC	male
GAGGTGAGTACATCCA	female
GAGGTGAGTCACTGGC	female
GAGGTGAGTGGCTCCA	male
GAGGTGAGTTCCACGG	female
GAGTCCGCAATAACGA	male
GAGTCCGCAGCTGCTG	male
GAGTCCGGTGATGATA	male
GAGTCCGGTTGCGTTA	female
GAGTCCGTCCGAACGC	male
GAGTCCGTCCTCAATT	female
GAGTCCGTCGCCAAAT	female
GATCAGTCACCTATCC	female
GATCAGTCATCCTAGA	male
GATCAGTTCACATAGC	male
GATCGATAGGCAATTA	female
GATCGATAGGCCATAG	male
GATCGATGTGAGTGAC	male
GATCGCGAGAACAATC	female
GATCGCGAGAAGATTC	male
GATCGCGAGTACACCT	female
GATCGCGAGTTACCCA	female
GATCGCGAGTTGAGTA	male
GATCGCGCAAGGACTG	female
GATCGCGCACGGTTTA	male
GATCGCGGTAGGAGTC	female
GATCGCGGTCTGCCAG	female
GATCGCGTCGTAGATC	male
GATCGTACAGTTCCCT	female
GATCGTAGTGCAACGA	male
GATCGTAGTGCAACTT	male
GATCGTAGTTGGTTTG	female
GATCGTAGTTTAAGCC	male
GATCGTATCGCCTGAG	male
GATCTAGAGCCGGTAA	male
GATCTAGCAACGATGG	female
GATCTAGCACCCAGTG	male
GATCTAGGTGGGTCAA	male
GATCTAGGTTATTCTC	female
GATCTAGTCCCAAGTA	female
GATCTAGTCGCCATAA	female
GATGAAAAGGATCGCA	male
GATGAAACAAGCTGGA	female
GATGAAACAGTAAGCG	male
GATGAAACATGTCCTC	female
GATGAAATCAACACTG	female
GATGAGGAGAGGGATA	female
GATGAGGAGCGTGAGT	female
GATGAGGCAAAGAATC	female
GATGAGGCAAGGACAC	male
GATGAGGGTCTCTCTG	female
GATGAGGTCAACACCA	female
GATGAGGTCACGAAGG	male
GATGCTAAGAGACGAA	male
GATGCTAAGGTGTGGT	male
GATGCTACACCGAATT	female
GATGCTACAGCTCGCA	male
GATGCTAGTACTCTCC	female
GATGCTAGTCGTTGTA	female
GATGCTAGTTGGACCC	female
GATGCTATCACCATAG	male
GATGCTATCGCCATAA	female
GATGCTATCGCGTTTC	male
GATGCTATCTGCCCTA	female
GATTCAGAGATAGCAT	female
GATTCAGAGCACCGCT	female
GATTCAGGTAATCACC	female
GATTCAGTCGATCCCT	male
GCAAACTAGTACGTTC	female
GCAAACTCAATGTTGC	male
GCAAACTCAGGAATCG	female
GCAAACTGTGCAACTT	female
GCAAACTGTTCGTGAT	female
GCAAACTTCAGCAACT	female
GCAAACTTCGCGATCG	female
GCAAACTTCTTGTACT	male
GCAATCAAGAAGATTC	female
GCAATCAAGGAATCGC	male
GCAATCAAGGAGTCTG	female
GCAATCAAGGATGCGT	female
GCAATCAAGTGTGGCA	female
GCAATCATCATAGCAC	female
GCACATAAGAACTCGG	female
GCACATAAGGGCATGT	male
GCACATACACGACGAA	male
GCACATATCAACGAAA	female
GCACTCTAGACAAGCC	female
GCACTCTCAGTTCATG	male
GCACTCTGTCAAGCGA	male
GCACTCTGTCTGATTG	female
GCACTCTTCAGCTTAG	female
GCACTCTTCATGCATG	male
GCACTCTTCCCAAGTA	male
GCAGCCAAGATGGCGT	female
GCAGCCACAATGGACG	female
GCAGCCACACGAGGTA	female
GCAGCCAGTACCGCTG	male
GCAGCCATCGTCGTTC	male
GCAGTTAAGCTAGTCT	male
GCAGTTAAGGTGGGTT	female
GCAGTTAAGTACCGGA	male
GCAGTTACAAGTCTGT	female
GCATACACATTGGCGC	female
GCATACAGTCAGAGGT	female
GCATACAGTGTGAATA	female
GCATGATAGCTGTTCA	male
GCATGATAGGCTAGGT	male
GCATGATGTTCCCGAG	female
GCATGATTCCTAGGGC	male
GCATGATTCTCCCTGA	male
GCATGCGAGAAGGCCT	male
GCATGCGGTCCGACGT	male
GCATGCGGTCGAATCT	male
GCATGCGGTCTACCTC	male
GCATGCGGTGCAGACA	male
GCATGCGTCTTTCCTC	male
GCATGTAAGAGGTTAT	male
GCATGTAAGTGATCGG	male
GCATGTACAGCGTCCA	female
GCATGTAGTCGAAAGC	female
GCATGTAGTTCCCGAG	male
GCCAAATCAGTATGCT	female
GCCAAATTCAAGGTAA	male
GCCAAATTCAATAAGG	male
GCCAAATTCTTCGGTC	male
GCCTCTAAGTGCCAGA	male
GCCTCTAAGTTGAGTA	male
GCCTCTAGTAAAGGAG	female
GCCTCTAGTTAAAGAC	female
GCCTCTAGTTATTCTC	female
GCCTCTATCCGGGTGT	female
GCCTCTATCGCATGAT	female
GCCTCTATCGCCAGCA	male
GCGACCAAGGTGATAT	male
GCGACCAGTCTTCGTC	female
GCGACCAGTTCCAACA	male
GCGAGAAAGCCACGTC	male
GCGAGAAAGTTACGGG	female
GCGAGAACAGCGTAAG	female
GCGAGAAGTTCACCTC	female
GCGCAACAGACTCGGA	female
GCGCAACAGTCGAGTG	female
GCGCAACAGTGGGTTG	female
GCGCAACCAAGGACAC	female
GCGCAACGTAGCGCTC	male
GCGCAGTAGCCGATTT	female
GCGCAGTAGTAGATGT	male
GCGCAGTCAGAGCCAA	male
GCGCCAACAACTGCGC	male
GCGCCAACAGTTCATG	male
GCGCCAACATTTGCTT	male
GCGCCAAGTGTAAGTA	male
GCGCCAATCAATCTCT	female
GCGCCAATCAGCATGT	female
GCGCGATAGTGATCGG	female
GCGCGATGTTCTGGTA	female
GCGCGATGTTTCGCTC	male
GCGCGATTCGACAGCC	male
GCGGGTTCACGCCAGT	female
GCTCCTAAGTACCGGA	female
GCTCCTAGTAGGCATG	female
GCTCCTAGTGCGGTAA	male
GCTCCTAGTTCCCGAG	male
GCTCCTATCTCGAGTA	male
GCTCTGTCACCACCAG	male
GCTCTGTGTGGCCCTA	female
GCTCTGTGTTACAGAA	male
GCTCTGTTCGAGGTAG	female
GCTGCAGCAGCTGTTA	female
GCTGCAGGTAGCGCAA	female
GCTGCAGGTCTTCAAG	female
GCTGCAGGTGCAACGA	male
GCTGCGAAGCTGTTCA	female
GCTGCGACAGGGTATG	female
GCTGCGAGTAGCGCTC	male
GCTGCGAGTGCGAAAC	female
GCTGCGATCATCGGAT	female
GCTGCGATCGGATGTT	female
GCTGCGATCTTACCTA	male
GCTGCTTAGATCACGG	female
GCTGCTTAGCAGATCG	male
GCTGCTTAGTGGAGAA	male
GCTGCTTCAGGGTACA	female
GCTGCTTCAGTCAGCC	female
GCTGCTTGTGTTCGAT	male
GCTGCTTGTTGTACAC	female
GCTGCTTTCTGCCCTA	female
GCTGGGTAGGTTCCTA	female
GCTGGGTCAATCACAC	female
GCTGGGTGTCAAAGCG	female
GCTGGGTGTCTGCCAG	male
GCTGGGTTCTTAACCT	male
GCTTCCAAGAGACGAA	female
GCTTCCAAGGACCACA	male
GCTTCCAAGGCAATTA	female
GCTTCCAGTGCTTCTC	male
GCTTCCATCCCATTTA	female
GCTTCCATCTGTCTAT	female
GCTTGAAAGCCGCCTA	male
GCTTGAAAGTGGAGTC	male
GCTTGAAAGTGTCCCG	male
GGAAAGCAGAGCTGCA	female
GGAAAGCAGATCCCGC	female
GGAAAGCCAGACGCTC	male
GGAAAGCGTACCAGTT	female
GGAACTTAGCGCTTAT	male
GGAACTTCAGCAGTTT	male
GGAACTTCAGCTGCTG	female
GGAACTTCATATGAGA	male
GGAACTTGTAAATGAC	male
GGAACTTTCAGTACGT	male
GGAACTTTCTTCGAGA	female
GGAATAAAGCCAACAG	male
GGAATAACAAGCTGTT	female
GGAATAAGTAACGACG	female
GGAATAATCCTCTAGC	male
GGACAAGAGCGTTTAC	female
GGACAAGAGGGCTTGA	female
GGACAAGCAAAGCAAT	male
GGACAAGCACCCAGTG	female
GGACAAGCATGATCCA	male
GGACAAGGTCATATGC	female
GGACAAGTCCCATTTA	male
GGACAGAAGTGTGGCA	female
GGACAGACACGGTAAG	male
GGACAGACATTAGCCA	male
GGACATTCACAGTCGC	male
GGACATTCATACGCCG	female
GGACATTCATATACCG	female
GGACATTGTACCCAAT	male
GGACATTGTCAGTGGA	female
GGACATTTCACTGGGC	male
GGACGTCAGAGTACAT	female
GGACGTCCAAAGGAAG	female
GGACGTCCACCAGTTA	female
GGACGTCGTCCAGTAT	male
GGACGTCGTCTTGATG	male
GGACGTCGTGGACGAT	male
GGACGTCGTTAAGACA	female
GGACGTCTCAATAAGG	male
GGACGTCTCTCGTTTA	male
GGAGCAAAGAGCCTAG	female
GGAGCAAAGCTGTTCA	female
GGAGCAACAGGACGTA	male
GGATGTTAGAGCTGGT	male
GGATGTTAGGCACATG	male
GGATGTTCACTTAAGC	female
GGATGTTCATCCTTGC	male
GGATGTTTCGCCATAA	male
GGATTACAGAGGACGG	male
GGATTACAGGACCACA	male
GGATTACAGGCTAGGT	female
GGATTACAGTCCATAC	male
GGATTACAGTCCGGTC	male
GGATTACCAAAGCAAT	male
GGATTACCACCGAATT	female
GGATTACCAGCTGTTA	female
GGATTACGTCGAGATG	male
GGCAATTAGACAATAC	female
GGCAATTGTAAGAGAG	female
GGCAATTTCTTGTACT	male
GGCCGATAGTTCGCAT	male
GGCCGATGTCGTGGCT	male
GGCGACTAGTGGTAGC	female
GGCGACTCAGTAGAGC	male
GGCGACTCAGTCAGCC	female
GGCGACTGTAAGTAGT	male
GGCGACTTCATCATTC	female
GGCGACTTCATCGATG	male
GGCGTGTCAAGCCGCT	male
GGCGTGTCATTTGCTT	male
GGCGTGTGTAGTAGTA	female
GGCGTGTGTCGACTAT	female
GGCGTGTGTCTGATCA	male
GGCGTGTTCATTATCC	male
GGCTCGAAGATGAGAG	female
GGCTCGAGTAGCGCAA	female
GGCTCGAGTGCTGTAT	male
GGCTCGATCAGGCAAG	male
GGCTCGATCGGCTTGG	female
GGCTGGTGTAGCGCAA	male
GGCTGGTGTTACGACT	male
GGCTGGTTCTACGAGT	female
GGGAATGGTCATACTG	male
GGGAATGGTGCACGAA	female
GGGACCTAGAGAACAG	female
GGGACCTCAACACCTA	male
GGGACCTCAAGCTGAG	male
GGGACCTCACCTATCC	female
GGGACCTCACTAAGTC	male
GGGACCTCAGAAGCAC	female
GGGACCTGTACCGAGA	female
GGGAGATAGCTGCGAA	female
GGGAGATCAGCAGTTT	male
GGGAGATGTCGCGTGT	female
GGGAGATGTGCTGTAT	male
GGGAGATTCCGTTGTC	female
GGGAGATTCTGATACG	male
GGGATGAAGTGTGGCA	male
GGGATGACACTATCTT	male
GGGATGAGTTCATGGT	female
GGGCACTAGTGGGATC	female
GGGCACTCATATACGC	male
GGGCACTTCAACACTG	male
GGGCACTTCGTATCAG	female
GGGCATCAGTCAATAG	male
GGGCATCAGTGTCCCG	male
GGGCATCCAGCGAACA	male
GGGCATCGTAAATACG	male
GGGCATCGTAGCGTAG	female
GGGCATCGTAGTAGTA	male
GGGCATCTCAAAGTAG	female
GGGCATCTCCGGCACA	male
GGGTCTGAGCGCCTTG	female
GGGTCTGCACAACTGT	male
GGGTCTGCAGTATCTG	male
GGGTCTGCAGTTCATG	male
GGGTCTGCATTACGAC	male
GGGTCTGGTAAGTTCC	male
GGGTTGCAGACAGAGA	female
GGGTTGCGTGGTAACG	female
GGGTTGCGTTCAGCGC	female
GGTATTGCAGCAGTTT	female
GGTATTGTCCGTAGGC	female
GGTGAAGAGTACGCGA	male
GGTGAAGCAATGGAAT	male
GGTGCGTAGATCGGGT	male
GGTGCGTCATAGGATA	male
GGTGCGTGTACGCACC	female
GGTGCGTGTCGTCTTC	female
GGTGCGTGTGTGCCTG	female
GGTGCGTGTTACTGAC	female
GGTGCGTTCTCCAGGG	male
GGTGCGTTCTTGTTTG	male
GGTGTTACACCGCTAG	female
GGTGTTACAGCTGGCT	female
GGTGTTACAGTCGATT	female
GGTGTTACATGGTAGG	female
GGTGTTAGTAAGGGAA	female
GGTGTTAGTGGTACAG	male
GGTGTTAGTTAGAACA	male
GGTGTTATCTGCGACG	male
GTAACGTAGCTACCGC	female
GTAACGTAGTCAATAG	female
GTAACGTAGTGGTAAT	male
GTAACGTCAAGCCGCT	male
GTAACGTCAGCGATCC	female
GTAACGTGTCGCGTGT	female
GTAACGTTCAGCCTAA	male
GTAACGTTCCAAGTAC	male
GTAACGTTCCGGCACA	male
GTAACTGAGAGTAATC	female
GTAACTGAGTATTGGA	female
GTAACTGGTAAGAGAG	female
GTAACTGGTCCCTTGT	male
GTAACTGGTTCAGACT	male
GTAACTGTCCACGTGG	female
GTACGTAAGAGTAATC	female
GTACGTACATCTATGG	female
GTACTCCCACCAGCAC	female
GTACTCCGTCAGAGGT	female
GTACTCCGTGACAAAT	male
GTACTCCTCTACTTAC	female
GTACTTTAGACAAAGG	male
GTACTTTCAAACAACA	male
GTACTTTCACTCTGTC	male
GTACTTTTCAGTACGT	male
GTACTTTTCCTTCAAT	female
GTACTTTTCTTTAGTC	male
GTAGGCCGTTGTCTTT	female
GTAGTCAAGAATCTCC	female
GTAGTCAAGGAGTTGC	female
GTAGTCAGTCTGATCA	male
GTAGTCAGTTGTTTGG	male
GTATCTTAGTACGTTC	male
GTATCTTAGTGGGCTA	male
GTATCTTGTAAGGGCT	female
GTATCTTTCGTCCGTT	female
GTATCTTTCTATCCCG	female
GTATCTTTCTGGTATG	female
GTATTCTGTTCCCGAG	male
GTATTCTTCGAGAACG	male
GTCAAGTCAGATGGGT	female
GTCAAGTCATGTCTCC	male
GTCAAGTGTGAGGGAG	female
GTCAAGTGTTTGCATG	female
GTCAAGTTCGTCCAGG	male
GTCACAAAGCTGAAAT	male
GTCACGGAGACAGGCT	female
GTCACGGCAATAGCAA	male
GTCACGGTCATTATCC	female
GTCACGGTCGAGCCCA	male
GTCATTTAGCGCCTTG	female
GTCATTTCATCACGTA	female
GTCATTTGTGCCTGGT	female
GTCATTTGTGTTGGGA	male
GTCATTTGTTCGCGAC	female
GTCATTTGTTGGTGGA	female
GTCATTTTCAGCGACC	male
GTCCTCAAGTATCGAA	male
GTCCTCAAGTCCATAC	female
GTCCTCACAATTGCTG	female
GTCCTCACAGCGTAAG	female
GTCCTCACAGGCTGAA	female
GTCCTCAGTCATCCCT	female
GTCCTCAGTTAAGAAC	female
GTCCTCAGTTGTGGCC	male
GTCCTCATCCAGGGCT	female
GTCCTCATCTACTATC	female
GTCGGGTGTATATGGA	female
GTCGGGTGTCCCTTGT	female
GTCGGGTGTGCAGTAG	female
GTCGGGTTCGGTTAAC	female
GTCGTAAAGACGCAAC	female
GTCGTAAAGCCCAACC	male
GTCGTAAGTCTAGCCG	male
GTCGTAATCGAGAGCA	male
GTCGTAATCTTGTCAT	male
GTCTCGTAGTTGAGAT	male
GTCTCGTAGTTGCAGG	male
GTCTCGTTCAAGATCC	female
GTCTCGTTCACAATGC	male
GTCTCGTTCCTCCTAG	male
GTCTCGTTCTGCCCTA	female
GTCTTCGAGAACTGTA	female
GTCTTCGGTGATGTGG	male
GTCTTCGTCCAAACAC	male
GTGAAGGCACAACGTT	female
GTGAAGGCACATCTTT	male
GTGCAGCAGAATGTGT	male
GTGCAGCAGAGCTGGT	female
GTGCAGCAGCGTCTAT	female
GTGCAGCCATTCCTCG	female
GTGCAGCGTGTGCCTG	female
GTGCAGCGTTCTGAAC	female
GTGCAGCTCAGTGTTG	male
GTGCAGCTCCGTCATC	male
GTGCAGCTCTATGTGG	female
GTGCAGCTCTCTAAGG	female
GTGCATAAGTCGTACT	male
GTGCATACAGGTGGAT	female
GTGCATACATGTCCTC	female
GTGCATAGTACCGAGA	male
GTGCATAGTAGGGACT	female
GTGCATATCGCCAGCA	female
GTGCGGTAGACAGGCT	male
GTGCGGTTCCTGTACC	female
GTGCTTCAGACTAGGC	female
GTGCTTCCAATGTAAG	female
GTGCTTCCACGTCTCT	male
GTGCTTCCACTACAGT	female
GTGCTTCGTCGCCATG	female
GTGCTTCGTGATAAGT	female
GTGGGTCAGGAGTACC	female
GTGGGTCCAAACTGCT	female
GTGGGTCCATGCCACG	male
GTGGGTCGTCCGTGAC	male
GTGGGTCGTGCTAGCC	male
GTGGGTCTCCACTGGG	female
GTGTGCGAGGGTTTCT	male
GTGTGCGCATGCATGT	female
GTGTGCGTCCTTGGTC	male
GTGTTAGAGAAGGGTA	female
GTGTTAGAGTGTGAAT	female
GTGTTAGCAAGTAATG	female
GTGTTAGCATCACAAC	male
GTGTTAGGTTATCCGA	female
GTGTTAGTCCTATGTT	female
GTTAAGCCAGGACCCT	male
GTTAAGCGTCTACCTC	female
GTTAAGCGTCTAGTGT	male
GTTAAGCTCACTTACT	female
GTTACAGAGGACATTA	male
GTTACAGCACCAGCAC	male
GTTCATTAGGCGACAT	female
GTTCATTCACAGAGGT	male
GTTCATTCATCCGGGT	male
GTTCATTGTAGAAAGG	female
GTTCATTGTAGTACCT	male
GTTCGGGAGCCCAACC	male
GTTCGGGTCGGATGGA	female
GTTCTCGCATGTAGTC	male
GTTCTCGTCTTCAACT	female
GTTTCTAAGGGCATGT	female
GTTTCTAAGTGTACCT	female
GTTTCTAGTCACACGC	male
GTTTCTAGTTGACGTT	female
GTTTCTATCCGAGCCA	male
TAAACCGAGTGGCACA	female
TAAACCGAGTGTGAAT	female
TAAACCGCATTAGGCT	male
TAAACCGGTATATCCG	male
TAAGAGAAGCCGCCTA	female
TAAGAGAAGGTTACCT	female
TAAGAGAGTTGGACCC	female
TAAGAGATCAAGGCTT	female
TAAGAGATCCGCGCAA	male
TAAGCGTAGATAGTCA	female
TAAGCGTAGGGTTCCC	female
TAAGCGTCACGGACAA	male
TAAGCGTTCAGTTTGG	female
TAAGTGCAGTACATGA	female
TAAGTGCGTAGCGTGA	male
TAAGTGCGTGAACCTT	female
TACACGATCGGTTCGG	male
TACAGTGAGCGTGAAC	female
TACAGTGAGTGGTAAT	female
TACAGTGCACGAAACG	female
TACAGTGGTTGCGTTA	male
TACCTATAGACAAAGG	female
TACCTATAGTCGATAA	male
TACCTATTCAGAGGTG	female
TACCTATTCCTGCCAT	female
TACCTATTCGTCACGG	female
TACCTTAAGGTGCTTT	female
TACGGATAGGCGCTCT	male
TACGGATCACACCGAC	female
TACGGATGTCGCATCG	female
TACGGGCAGCGATAGC	male
TACGGGCAGGGCTTCC	female
TACGGGCGTACGCTGC	female
TACGGGCGTATTCGTG	female
TACGGGCGTATTCTCT	female
TACGGGCGTCACACGC	female
TACGGTAAGACAGAGA	female
TACGGTAAGTCCTCCT	female
TACGGTACATCCTTGC	male
TACGGTAGTTGGTTTG	male
TACGGTATCTGCAAGT	female
TACGGTATCTTCTGGC	female
TACTCATAGCTAGTGG	male
TACTCATGTCCGAATT	male
TACTCATTCAACGGGA	female
TACTCATTCCAGTAGT	female
TACTCATTCGCTTGTC	female
TACTCGCAGCTAGCCC	female
TACTCGCAGGAATCGC	male
TACTCGCAGGTACTCT	female
TACTCGCAGTTCCACA	male
TACTCGCTCACGCGGT	male
TACTCGCTCGGCGCTA	female
TACTTACAGCGTAATA	female
TACTTACAGTAGGCCA	male
TACTTACTCAGAGCTT	female
TACTTACTCATGCATG	female
TACTTACTCCGTCATC	male
TACTTGTAGAGCAATT	female
TACTTGTCACGTCTCT	female
TACTTGTCAGCTTAAC	female
TACTTGTGTCCATCCT	male
TACTTGTTCCCATTTA	male
TAGACCAAGCGCTCCA	female
TAGACCAAGGGAACGG	male
TAGACCACAAGCGATG	male
TAGACCACAGACAAGC	female
TAGACCAGTAAATGTG	female
TAGACCAGTAGCCTAT	male
TAGACCAGTCTAGTCA	male
TAGACCATCCCAGGTG	female
TAGACCATCCCATTAT	female
TAGAGCTAGGCGACAT	female
TAGAGCTCACCCATTC	male
TAGAGCTGTAAAGGAG	female
TAGAGCTGTAGTAGTA	female
TAGCCGGAGAGGGCTT	female
TAGCCGGAGCACACAG	male
TAGCCGGAGTCGAGTG	female
TAGGCATAGACCTAGG	female
TAGGCATAGTGTACGG	male
TAGGCATCAATGGAGC	male
TAGGCATCAGCCACCA	male
TAGGCATGTTTGGCGC	male
TAGTGGTGTCGTGGCT	male
TAGTGGTTCTGAGGGA	male
TAGTTGGCAGGCTCAC	female
TAGTTGGGTATGAATG	male
TAGTTGGGTGGTTTCA	male
TATCAGGAGCGTCTAT	female
TATCAGGGTCTAAACC	male
TATCAGGGTGTGAAAT	male
TATCAGGGTTTAAGCC	female
TATCAGGTCCCAAGAT	female
TATCTCAAGGAATCGC	female
TATCTCACAGACGCTC	male
TATCTCAGTAGGGACT	female
TATCTCAGTATCTGCA	female
TATCTCAGTGAGTGAC	female
TATCTCAGTGTAAGTA	female
TATCTCAGTTCTGGTA	female
TATGCCCAGCAACGGT	female
TATGCCCGTACTCGCG	female
TATGCCCGTCCAGTTA	female
TATGCCCGTGTTTGGT	male
TATGCCCTCAACACCA	female
TATGCCCTCGGTCTAA	male
TATTACCAGAGACGAA	female
TATTACCAGGAGCGTT	male
TATTACCCAGTAAGCG	male
TATTACCGTACTCTCC	female
TATTACCTCCAGTAGT	female
TATTACCTCTGTGCAA	female
TATTACCTCTTTCCTC	male
TCAACGACAAACCCAT	male
TCAACGACAGTTTACG	female
TCAACGAGTATTCTCT	male
TCAATCTAGAGAACAG	male
TCAATCTAGTGTTTGC	male
TCAATCTCAGACGCAA	male
TCAATCTCATCCCATC	male
TCAATCTCATGTTCCC	male
TCAATCTTCTGCGACG	female
TCAATCTTCTTGTACT	male
TCACAAGAGTTGCAGG	male
TCACAAGCAATACGCT	male
TCACAAGCAATCGGTT	female
TCACAAGCACGGACAA	male
TCACAAGCACGGTAGA	female
TCACAAGCACGTGAGA	female
TCACGAAAGTCTCCTC	female
TCACGAACATGTCTCC	male
TCACGAAGTGGTCCGT	female
TCACGAATCATACGGT	male
TCACGAATCTATGTGG	male
TCAGATGCATGCCTTC	female
TCAGATGGTAACGCGA	male
TCAGATGGTTCTCATT	female
TCAGATGTCGACCAGC	female
TCAGATGTCGCATGGC	female
TCAGATGTCTATGTGG	male
TCAGCAACACACGCTG	female
TCAGCAAGTACCGTTA	male
TCAGCAATCCATGAGT	female
TCAGCTCAGGAATGGA	male
TCAGCTCCAAGCGAGT	male
TCAGCTCGTTGGTTTG	female
TCAGCTCTCATGTGGT	male
TCAGGATAGACATAAC	female
TCAGGATAGTGCAAGC	female
TCAGGATAGTGGGTTG	female
TCAGGATCATTGGTAC	male
TCAGGATTCAGCTTAG	female
TCAGGATTCCAGGGCT	female
TCAGGATTCTCAAACG	male
TCAGGTACAAGAAAGG	male
TCAGGTACAATTCCTT	female
TCAGGTAGTTCGTCTC	male
TCATTACAGCCAGTTT	female
TCATTACCAGTAAGAT	female
TCATTACGTTCTGTTT	male
TCATTACTCGCACTCT	female
TCATTTGCACTATCTT	female
TCATTTGGTCTGCAAT	male
TCATTTGTCAGTACGT	female
TCATTTGTCATTCACT	male
TCATTTGTCGCAAACT	male
TCCACACCAATGTAAG	female
TCCACACCAGATGAGC	male
TCCACACGTAAGAGAG	female
TCCACACGTCATCCCT	male
TCCACACGTTAAAGAC	male
TCCCGATCAAGAAGAG	male
TCCCGATCATGATCCA	male
TCGAGGCAGCGTCAAG	male
TCGAGGCCACGCATCG	female
TCGAGGCGTCAATGTC	female
TCGAGGCTCCGATATG	female
TCGAGGCTCCTCTAGC	female
TCGCGAGCAAAGAATC	female
TCGCGAGGTACCGCTG	male
TCGCGAGGTCGGCATC	female
TCGCGAGTCTGTCCGT	female
TCGCGTTAGTACATGA	female
TCGCGTTGTTCGTTGA	male
TCGCGTTGTTCTGGTA	male
TCGCGTTTCGACGGAA	female
TCGGGACAGAGAACAG	male
TCGGGACAGTTACGGG	female
TCGGGACCAAGGTTCT	female
TCGGGACGTGATGTGG	female
TCGGGACGTGTCGCTG	female
TCGGGACGTGTTCTTT	male
TCGGGACTCGAGAGCA	female
TCGGTAACAGTAAGAT	male
TCGGTAAGTCAGCTAT	female
TCGGTAAGTGATGCCC	female
TCGGTAAGTGGCAAAC	female
TCGGTAATCAAACCGT	male
TCGGTAATCAAGCCTA	male
TCGGTAATCCCACTTG	female
TCGGTAATCGTAGGTT	male
TCGTACCAGCGTTTAC	female
TCGTACCCAGCTCCGA	male
TCGTACCTCATCGCTC	female
TCGTACCTCTATCCTA	female
TCGTAGAAGATCCCAT	male
TCGTAGACAGCCAGAA	female
TCGTAGACATGCCCGA	male
TCTATTGCATGTCTCC	male
TCTATTGTCTGGAGCC	female
TCTCATACACCAGGCT	female
TCTCATACACGAGGTA	male
TCTCATAGTAGCGTGA	female
TCTCATAGTGCATCTA	male
TCTCATAGTGGTTTCA	female
TCTCATAGTGTCCTCT	male
TCTCATAGTTACGCGC	male
TCTCATAGTTCAACCA	female
TCTCATATCCCTTGTG	female
TCTCTAACAAGTTCTG	male
TCTCTAAGTTGTCTTT	female
TCTGAGAAGACCACGA	female
TCTGAGAAGATGAGAG	female
TCTGAGAAGCACCGTC	female
TCTGAGAAGCGTCTAT	male
TCTGAGACACTGTCGG	female
TCTGAGATCATATCGG	female
TCTGGAAGTACTCGCG	male
TCTGGAAGTCTCTCGT	female
TCTTCGGAGCTAAACA	female
TCTTCGGCAAGCGTAG	male
TCTTCGGGTGCGAAAC	female
TCTTTCCAGGCGCTCT	female
TCTTTCCGTCGGGTCT	male
TCTTTCCGTCTGGTCG	male
TCTTTCCGTTACCGAT	male
TCTTTCCTCTGCGACG	female
TGAAAGAAGTATTGGA	female
TGAAAGACACTAGTAC	male
TGAAAGAGTACACCGC	female
TGAAAGAGTAGAGTGC	female
TGAAAGAGTTATTCTC	male
TGAAAGATCAACACCA	female
TGAAAGATCACGCATA	female
TGACAACAGCACAGGT	female
TGACAACGTACCTACA	male
TGACAACTCTCTGTCG	female
TGACAACTCTTTCCTC	male
TGACGGCAGATACACA	female
TGACGGCAGTACACCT	female
TGACGGCGTCACACGC	female
TGACGGCGTCTCGTTC	female
TGACGGCTCAGTTGAC	male
TGACTAGAGAGCAATT	male
TGACTAGAGGAGTTGC	female
TGACTAGCACTGTTAG	female
TGACTAGCAGCCTATA	female
TGACTAGTCAGAGCTT	female
TGACTAGTCATCGATG	male
TGACTAGTCGCGTTTC	female
TGACTTTAGCCTCGTG	male
TGACTTTAGCTTTGGT	female
TGACTTTAGTATTGGA	male
TGACTTTCAGACAGGT	male
TGACTTTGTCAGTGGA	female
TGAGAGGAGACAGACC	female
TGAGAGGAGCTGAAAT	male
TGAGAGGAGGCCGAAT	male
TGAGAGGAGTGAACGC	female
TGAGAGGGTAAGAGGA	male
TGAGAGGGTGTGACGA	female
TGAGAGGTCAGTACGT	female
TGAGAGGTCGTTGACA	female
TGAGAGGTCGTTTGCC	female
TGAGCATAGAGCTGGT	female
TGAGCATAGGTGTTAA	female
TGAGCATGTACTTCTT	male
TGAGCATGTAGCGTCC	female
TGAGCATGTCCGAAGA	male
TGAGCATGTGGTTTCA	female
TGAGCATTCAGAAATG	male
TGAGCATTCATTTGGG	male
TGAGCATTCCCAAGAT	male
TGAGCCGAGACTACAA	male
TGAGCCGGTTCAACCA	female
TGAGCCGGTTTGTTGG	female
TGAGGGAAGGACCACA	male
TGAGGGACAGCGTAAG	male
TGAGGGACATCGATTG	female
TGAGGGACATGAGCGA	female
TGAGGGATCTAACTCT	female
TGATTTCAGCGCTCCA	male
TGATTTCCATTAACCG	male
TGATTTCTCTGTCTAT	female
TGATTTCTCTTGTACT	male
TGCACCTGTGCGAAAC	male
TGCACCTGTGTTAAGA	female
TGCACCTTCGAACGGA	male
TGCACCTTCTATCGCC	male
TGCCAAAAGAAGGACA	female
TGCCAAAAGAGGTTGC	female
TGCCAAAAGTCAAGGC	male
TGCCAAACACAGAGGT	male
TGCCAAACAGAGTGTG	male
TGCCAAACAGGAATCG	male
TGCCAAAGTGCCTGCA	male
TGCCAAATCCACGCAG	female
TGCCCATAGATGTCGG	male
TGCCCATGTCATCCCT	female
TGCCCATGTCTAGCCG	female
TGCCCATGTCTAGGTT	male
TGCCCATTCACCCGAG	male
TGCCCATTCTCAAACG	male
TGCCCTAAGACAGACC	female
TGCCCTACAGTCACTA	male
TGCCCTACATAGGATA	male
TGCCCTACATGTCCTC	male
TGCCCTAGTCAGAGGT	male
TGCCCTAGTGGACGAT	male
TGCCCTATCCCAAGAT	male
TGCCCTATCGAGCCCA	female
TGCCCTATCTGAAAGA	female
TGCGCAGGTGAGCGAT	female
TGCGCAGTCGCAAACT	male
TGCGGGTAGTGCTGCC	female
TGCGGGTCAGACGTAG	male
TGCGGGTGTGTCGCTG	female
TGCGGGTGTTGTCGCG	male
TGCGGGTTCCTCGCAT	male
TGCGTGGAGCTAGCCC	female
TGCGTGGCACGAGGTA	male
TGCGTGGCATGGTCTA	female
TGCGTGGGTGATGCCC	female
TGCGTGGTCGTAGGTT	female
TGCTACCAGCTGCCCA	female
TGCTACCAGTACGCCC	male
TGCTACCCACAGCGTC	male
TGCTACCGTTACGCGC	female
TGCTACCTCCGTTGTC	female
TGCTACCTCGCTTAGA	male
TGCTACCTCTTGACGA	male
TGCTGCTAGCGTTGCC	female
TGCTGCTAGGCTAGCA	male
TGCTGCTAGTCAAGCG	female
TGCTGCTTCAATCTCT	male
TGCTGCTTCACTCTTA	male
TGGACGCGTGACAAAT	male
TGGACGCGTGTATGGG	female
TGGACGCTCTGGCGAC	female
TGGCCAGAGCGTTTAC	male
TGGCCAGTCTGGTATG	male
TGGCGCACAGATCTGT	female
TGGCGCAGTCATTAGC	female
TGGCTGGAGTAGCGGT	male
TGGCTGGCACACGCTG	female
TGGCTGGGTACTCAAC	male
TGGCTGGGTGGCGAAT	female
TGGGAAGAGAGCTGGT	male
TGGGAAGAGGCAGTCA	male
TGGGAAGCAATAGCGG	female
TGGGAAGCATAGGATA	male
TGGGAAGTCCACGACG	male
TGGGAAGTCGTATCAG	male
TGGGCGTAGTAGGTGC	female
TGGGCGTTCAATACCG	female
TGGTTAGCAACAACCT	female
TGGTTAGCAGTTAACC	male
TGGTTAGGTCCAGTTA	male
TGGTTCCAGATGCCTT	male
TGGTTCCAGATTACCC	male
TGGTTCCAGGAGTAGA	male
TGGTTCCCAAGAGGCT	male
TGGTTCCTCACGACTA	male
TGGTTCCTCTCGGACG	male
TGTATTCAGCTTTGGT	female
TGTATTCCACGGTTTA	male
TGTATTCTCGGAATCT	female
TGTATTCTCGTATCAG	female
TGTCCCACAGGATCGA	male
TGTCCCAGTTATCGGT	female
TGTCCCATCCGTAGTA	male
TGTGGTAAGATCCCGC	male
TGTGGTAAGCATCATC	female
TGTGGTAAGCTGCAAG	female
TGTGGTACACTAAGTC	female
TGTGGTACATGGTCTA	female
TGTGGTAGTTCTGGTA	female
TGTGGTAGTTGATTCG	female
TGTGGTATCCTAGTGA	female
TGTGTTTAGAGGGATA	female
TGTGTTTCAGACGCAA	male
TGTGTTTCAGATCCAT	male
TGTGTTTGTAACGCGA	male
TGTGTTTGTGCACGAA	male
TGTGTTTTCCACGCAG	male
TGTGTTTTCGGCGCTA	female
TGTTCCGAGACTAAGT	male
TGTTCCGAGCCTTGAT	male
TGTTCCGAGGAGCGTT	male
TGTTCCGTCGTGACAT	male
TTAACTCAGTCCGTAT	male
TTAACTCAGTTTGCGT	female
TTAACTCCATGACATC	male
TTAACTCCATGAGCGA	female
TTAGGACAGTTACGGG	female
TTAGGACCAGATCCAT	male
TTAGGACCATCATCCC	female
TTAGGACCATTGGTAC	female
TTAGGACTCAGGTAAA	male
TTAGGACTCGGAGGTA	female
TTAGGCAGTGACCAAG	male
TTAGGCAGTGGTCTCG	female
TTAGGCATCAAACGGG	female
TTAGGCATCACTCTTA	female
TTAGTTCCAGGACCCT	female
TTAGTTCGTGCACTTA	female
TTAGTTCTCAAACAAG	female
TTAGTTCTCGTTACAG	female
TTATGCTAGGACAGCT	male
TTATGCTGTGAGCGAT	female
TTATGCTGTTCCACAA	female
TTCCCAGCACACGCTG	female
TTCCCAGGTCATACTG	male
TTCCCAGGTTCATGGT	male
TTCCCAGGTTTGCATG	female
TTCGAAGAGAGTCTGG	male
TTCGAAGAGCTGCCCA	female
TTCGAAGCAACAACCT	male
TTCGAAGCACTGTTAG	male
TTCGAAGCATGGGAAC	male
TTCGAAGGTTTAAGCC	female
TTCGAAGTCCTTTCGG	female
TTCGGTCAGCCACGTC	male
TTCGGTCAGGGTGTGT	female
TTCGGTCGTCTAAACC	male
TTCGGTCGTTCCGTCT	male
TTCGGTCTCACCGTAA	male
TTCTACAAGAAGGACA	female
TTCTACACACTTCGAA	male
TTCTACAGTCCATCCT	female
TTCTACAGTGCGATAG	female
TTCTACATCAACTCTT	male
TTCTCAAAGAGCCCAA	female
TTCTCAAAGAGGTTGC	female
TTCTCAAAGGCTAGAC	female
TTCTCAAAGTGACATA	male
TTCTCAACAAAGGCGT	female
TTCTCAACAAGGGTCA	male
TTCTCAACATATGAGA	female
TTCTCAACATCTACGA	male
TTCTCAAGTGGTCTCG	female
TTCTCAATCTTTACAC	male
TTCTCCTCAAGAGGCT	female
TTCTCCTCAAGTTGTC	female
TTCTCCTCATACAGCT	male
TTCTCCTGTGGGTCAA	female
TTCTCCTGTGTGACCC	male
TTCTTAGAGGCTAGCA	female
TTCTTAGGTGGTACAG	female
TTGAACGAGAAGGACA	male
TTGAACGCAATCGGTT	female
TTGAACGCAATGGACG	female
TTGAACGTCTGGCGTG	female
TTGACTTAGCTCTCGG	female
TTGACTTAGGTCATCT	male
TTGACTTTCAGAGGTG	male
TTGCCGTAGCAGCCTC	female
TTGCCGTCAAAGTGCG	male
TTGCCGTGTAAATGTG	female
TTGCCGTTCTTCAACT	male
TTGCGTCAGATATACG	female
TTGCGTCAGTAGGTGC	male
TTGCGTCCAGCTGTGC	female
TTGCGTCGTGGTAACG	male
TTGGAACAGATCTGCT	female
TTGGAACAGCGTTTAC	male
TTGGAACGTCCTAGCG	female
TTGGAACGTCTAGTCA	male
TTGGAACGTGTAAGTA	female
TTGGAACTCAAACGGG	male
TTGGAACTCTCAAACG	female
TTGGAACTCTCTAAGG	female
TTGGCAATCATGCTCC	female
TTGGCAATCGTCTGCT	female
TTGTAGGGTACCGTTA	female
TTGTAGGTCAGAGGTG	male
TTGTAGGTCGCTAGCG	female
TTTACTGTCGGCTACG	male
TTTATGCAGGCAATTA	female
TTTATGCCATCGATTG	female
TTTATGCGTTTGACTG	female
TTTATGCTCGATCCCT	male
TTTATGCTCGCCAGCA	female
TTTATGCTCTACTATC	male
TTTCCTCCAGGTGCCT	female
TTTGCGCAGCATCATC	female
TTTGCGCGTATAGGTA	male
TTTGCGCTCGGAAACG	female
TTTGGTTCACTGAAGG	male
TTTGGTTGTAGCCTCG	male
TTTGGTTGTCATATCG	male
TTTGGTTTCAGTTCGA	female
TTTGGTTTCTACTATC	male
TTTGTCACAACACGCC	female
TTTGTCACAAGTCTGT	male
TTTGTCACACCAGTTA	male
TTTGTCAGTGTGAATA	male
TTTGTCAGTTCGGGCT	female
TTTGTCATCTCCCTGA	female