Cell_Barcode	Sex
AAACCTGCACGTCAGC	female
AAACCTGCAGATTGCT	female
AAACCTGTCAGTTTGG	female
AAACGGGAGCGTCTAT	male
AAACGGGAGCTTCGCG	male
AAACGGGAGGTGCTAG	male
AAACGGGCATCCGTGG	female
AAACGGGCATGGGACA	male
AAACGGGCATTGGGCC	male
AAACGGGCATTTGCTT	male
AAACGGGGTTACGACT	male
AAACGGGTCATCGATG	female
AAACGGGTCATGTCTT	female
AAACGGGTCCAAGTAC	male
AAACGGGTCCATGAGT	male
AAACGGGTCGCCAGCA	female
AAACGGGTCGGATGGA	male
AAAGATGAGACGCTTT	female
AAAGATGAGAGCCCAA	female
AAAGATGAGAGTACAT	male
AAAGATGAGCAACGGT	female
AAAGATGAGCGATATA	male
AAAGATGAGCTGTCTA	female
AAAGATGCACGAGGTA	male
AAAGATGCACTCGACG	male
AAAGATGTCACTTCAT	male
AAAGATGTCAGTGTTG	male
AAAGATGTCATTCACT	male
AAAGATGTCGGTGTCG	female
AAAGCAAAGACTGGGT	male
AAAGCAAAGATAGGAG	male
AAAGCAAAGGAGTCTG	male
AAAGCAAAGTAGGTGC	male
AAAGCAAAGTCCGTAT	male
AAAGCAACACTTGGAT	female
AAAGCAACAGGAATCG	female
AAAGCAAGTCTCACCT	female
AAAGCAAGTCTTTCAT	female
AAAGCAAGTTACCGAT	female
AAAGCAATCAGCTCGG	male
AAAGCAATCAGTCAGT	male
AAAGCAATCCAATGGT	male
AAAGCAATCTCCCTGA	male
AAAGCAATCTCGCATC	male
AAAGTAGAGCGTGAAC	male
AAAGTAGAGCTGGAAC	female
AAAGTAGAGGACAGAA	female
AAAGTAGAGGACTGGT	female
AAAGTAGAGTGGCACA	male
AAAGTAGGTACTTAGC	male
AAAGTAGGTAGCGATG	female
AAAGTAGGTTGAGTTC	male
AAAGTAGTCAGCCTAA	male
AAAGTAGTCCTATTCA	female
AAATGCCAGCGTCAAG	male
AAATGCCAGGCGTACA	female
AAATGCCCAATTGCTG	female
AAATGCCCACGGATAG	male
AAATGCCCACGTTGGC	male
AAATGCCCAGATCTGT	female
AAATGCCCAGGTCTCG	female
AAATGCCCATGGGACA	male
AAATGCCTCCGTTGTC	female
AAATGCCTCTTCAACT	male
AACACGTAGATCCCGC	male
AACACGTAGCGATATA	male
AACACGTAGTTGAGTA	female
AACACGTCAATGGTCT	female
AACACGTCACAAGACG	male
AACACGTCAGCCAATT	female
AACACGTCATTGTGCA	male
AACACGTGTACCATCA	female
AACACGTGTGACTCAT	male
AACACGTTCCAATGGT	male
AACACGTTCCCGACTT	male
AACACGTTCTGCCAGG	female
AACACGTTCTTTACAC	male
AACCATGCAAATTGCC	male
AACCATGCACATCTTT	female
AACCATGGTTAAGTAG	male
AACCATGTCGCGCCAA	male
AACCGCGAGACGACGT	female
AACCGCGAGAGCTGCA	female
AACCGCGAGATCTGAA	male
AACCGCGAGCCAGAAC	male
AACCGCGAGCTGAAAT	female
AACCGCGCAAGCCATT	male
AACCGCGCAGCTGCTG	male
AACCGCGCATCGTCGG	female
AACCGCGGTCAACTGT	female
AACCGCGGTCGCCATG	male
AACCGCGGTGTTCGAT	male
AACCGCGTCCAAACAC	male
AACCGCGTCCTCGCAT	male
AACCGCGTCGGCTACG	female
AACGTTGAGAGCTATA	female
AACGTTGAGGACGAAA	female
AACGTTGCAAGGGTCA	male
AACGTTGCAGCTGCAC	female
AACGTTGGTCAACATC	female
AACGTTGGTCATATGC	female
AACGTTGGTTATGTGC	female
AACGTTGGTTCAACCA	male
AACGTTGGTTGGGACA	male
AACGTTGTCACTATTC	female
AACGTTGTCACTCCTG	male
AACGTTGTCGTAGGTT	male
AACTCAGAGGAACTGC	female
AACTCAGAGTGGGATC	male
AACTCAGCAATGACCT	female
AACTCAGCACCACGTG	female
AACTCAGCAGCATACT	female
AACTCAGCATTCTCAT	female
AACTCAGTCGCACTCT	male
AACTCAGTCTCTTGAT	female
AACTCCCAGATAGCAT	female
AACTCCCAGTGATCGG	male
AACTCCCAGTTTGCGT	male
AACTCCCCAAGAGTCG	male
AACTCCCCAATGGAAT	male
AACTCCCCATTCTTAC	male
AACTCCCGTATAGGTA	male
AACTCCCGTGATGCCC	female
AACTCCCGTTATCACG	female
AACTCCCTCATCACCC	male
AACTCCCTCATGCTCC	male
AACTCTTAGGTAGCTG	male
AACTCTTCAAGAAAGG	female
AACTCTTCACCGCTAG	male
AACTCTTCAGCTCGCA	female
AACTCTTGTCTCCACT	male
AACTCTTGTTTAGGAA	female
AACTCTTTCACTATTC	male
AACTCTTTCACTTCAT	female
AACTCTTTCAGTTTGG	female
AACTCTTTCGCACTCT	male
AACTGGTAGGATCGCA	male
AACTGGTCAGCCTGTG	male
AACTGGTCATCATCCC	female
AACTGGTCATTTCACT	female
AACTGGTGTCAATGTC	female
AACTGGTGTGCCTGGT	female
AACTGGTTCCACGACG	female
AACTGGTTCCCTGACT	female
AACTGGTTCCTTTACA	male
AACTGGTTCGCGGATC	male
AACTGGTTCGTCCAGG	female
AACTTTCAGTGCTGCC	female
AACTTTCCAAACTGCT	female
AACTTTCCATACGCTA	male
AACTTTCGTAAATACG	male
AACTTTCGTTCGGCAC	female
AACTTTCGTTTGTTTC	female
AACTTTCTCACTGGGC	female
AACTTTCTCGGTGTCG	male
AAGACCTAGGGTATCG	male
AAGACCTAGTCAAGGC	female
AAGACCTAGTCTCCTC	male
AAGACCTAGTCTTGCA	male
AAGACCTCAACACCCG	female
AAGACCTTCAGCGATT	female
AAGACCTTCCACGTTC	male
AAGACCTTCCTAGGGC	female
AAGACCTTCGCCATAA	female
AAGCCGCAGACAATAC	female
AAGCCGCAGACTCGGA	male
AAGCCGCCATTAGCCA	male
AAGCCGCGTACTTAGC	male
AAGCCGCGTAGGCTGA	female
AAGCCGCGTGAGTATA	male
AAGCCGCTCCAATGGT	female
AAGCCGCTCTAACTGG	female
AAGGAGCAGAAGGTGA	male
AAGGAGCAGACCGGAT	female
AAGGAGCAGCTGCAAG	female
AAGGAGCAGGTTCCTA	male
AAGGAGCAGTGCCATT	female
AAGGAGCCACCTCGGA	female
AAGGAGCGTGAAGGCT	female
AAGGAGCTCATTCACT	male
AAGGCAGAGCGTTTAC	male
AAGGCAGAGGATGGTC	male
AAGGCAGAGGGAGTAA	female
AAGGCAGAGTACTTGC	male
AAGGCAGCAATTGCTG	male
AAGGCAGCACATGTGT	male
AAGGCAGGTCCAGTGC	female
AAGGCAGGTCCGAGTC	male
AAGGCAGTCCTAGGGC	female
AAGGCAGTCCTTTCGG	male
AAGGCAGTCTGATTCT	female
AAGGTTCAGAAGGACA	male
AAGGTTCAGACCTTTG	female
AAGGTTCAGGAGTTGC	female
AAGGTTCAGTAAGTAC	male
AAGGTTCAGTCGTTTG	male
AAGGTTCAGTGTCCCG	female
AAGGTTCCAAGGTGTG	female
AAGGTTCGTACTCAAC	male
AAGGTTCGTTGCTCCT	female
AAGGTTCGTTTGACTG	female
AAGGTTCTCTCACATT	male
AAGGTTCTCTGTCCGT	male
AAGGTTCTCTTCGGTC	female
AAGTCTGAGTGGAGAA	male
AAGTCTGCAATGGATA	male
AAGTCTGCACTGTTAG	male
AAGTCTGGTAGTACCT	male
AAGTCTGGTTAAGACA	male
AAGTCTGTCACGCATA	female
AAGTCTGTCTTGAGAC	male
AATCCAGAGAAGCCCA	male
AATCCAGAGAAGGGTA	female
AATCCAGAGAGACTTA	male
AATCCAGAGAGCTATA	male
AATCCAGAGTACCGGA	female
AATCCAGCAAGTAATG	female
AATCCAGGTAAGTAGT	female
AATCCAGGTCTTGCGG	female
AATCCAGGTGTGAAAT	male
AATCCAGGTGTGAATA	male
AATCCAGTCCAAGTAC	female
AATCGGTAGAACTGTA	male
AATCGGTAGCACCGCT	male
AATCGGTAGGGTCGAT	female
AATCGGTCACCGAAAG	male
AATCGGTCAGGAATGC	male
AATCGGTGTAGCGATG	female
AATCGGTGTCGAACAG	female
AATCGGTGTGACTACT	female
AATCGGTGTTAAGATG	male
AATCGGTTCCCTCAGT	female
ACACCAAAGCGGCTTC	female
ACACCAAAGGAGCGTT	female
ACACCAACACAACGCC	male
ACACCAACAGCGATCC	male
ACACCAAGTCGAGATG	male
ACACCAAGTGTGAAAT	male
ACACCAATCCTAGAAC	male
ACACCCTGTAGTAGTA	female
ACACCCTGTGACCAAG	male
ACACCCTTCAGCTCTC	male
ACACCCTTCCACGACG	male
ACACCGGAGCTGAACG	female
ACACCGGAGGCTACGA	male
ACACCGGAGGTGCACA	male
ACACCGGAGTACTTGC	female
ACACCGGGTGAACCTT	male
ACACCGGTCCACGAAT	male
ACACCGGTCCATTCTA	male
ACACTGAAGAATCTCC	male
ACACTGAAGCACAGGT	male
ACACTGAAGTGCTGCC	female
ACACTGAGTGAAGGCT	male
ACACTGAGTGAGTATA	female
ACACTGAGTTACTGAC	female
ACACTGAGTTTGGCGC	female
ACACTGATCCAAACTG	female
ACAGCCGAGCCATCGC	female
ACAGCCGAGTACGATA	female
ACAGCCGAGTTACGGG	male
ACAGCCGCAACTTGAC	female
ACAGCCGGTTCCGTCT	male
ACAGCCGTCGCAGGCT	male
ACAGCCGTCTGGCGAC	female
ACAGCCGTCTTGGGTA	female
ACAGCTAAGCGCTTAT	male
ACAGCTAAGTTATCGC	female
ACAGCTACAGCTATTG	female
ACAGCTAGTTCGTTGA	male
ACAGCTAGTTTAAGCC	male
ACAGCTATCCAAGCCG	female
ACATACGAGCCAACAG	male
ACATACGAGCCACCTG	female
ACATACGAGCGATAGC	male
ACATACGAGCGTTGCC	male
ACATACGCAAACTGTC	male
ACATACGCAAGTTCTG	female
ACATACGCACTCTGTC	female
ACATACGCAGTATCTG	female
ACATACGGTCCGAATT	male
ACATACGGTGGTACAG	female
ACATACGGTTATTCTC	female
ACATACGTCATATCGG	female
ACATACGTCCAATGGT	male
ACATACGTCCCAAGTA	female
ACATACGTCGAATCCA	male
ACATACGTCGAGGTAG	female
ACATCAGAGCTGCGAA	female
ACATCAGAGGCAGTCA	female
ACATCAGCAGACAAAT	male
ACATCAGCAGATAATG	female
ACATCAGCAGCTATTG	female
ACATCAGCAGGTGGAT	male
ACATCAGGTACCGAGA	male
ACATCAGGTGTATGGG	male
ACATCAGGTTCAACCA	male
ACATCAGGTTCAGACT	male
ACATCAGTCGTCTGAA	female
ACATCAGTCTCGCTTG	female
ACATCAGTCTGGTATG	female
ACATGGTAGCGTTCCG	male
ACATGGTAGTAGGTGC	male
ACATGGTCAAACTGTC	male
ACATGGTCATTACCTT	female
ACCAGTAAGCCACGTC	male
ACCAGTAAGCTAGCCC	male
ACCAGTACACGCTTTC	male
ACCAGTACACTGAAGG	male
ACCAGTACATCATCCC	male
ACCAGTACATCCTTGC	male
ACCAGTAGTAATCGTC	male
ACCAGTAGTGGGTCAA	male
ACCAGTAGTTTAAGCC	female
ACCAGTATCAACACAC	female
ACCCACTAGTGGGTTG	female
ACCCACTCATTATCTC	female
ACCCACTGTAGAGCTG	male
ACCCACTGTTAAAGAC	female
ACCCACTGTTCAGGCC	male
ACCCACTTCAGTTGAC	male
ACCCACTTCCAGAGGA	female
ACCCACTTCCAGATCA	male
ACCCACTTCTGAAAGA	male
ACCGTAACAAAGCGGT	female
ACCGTAACAATGGTCT	male
ACCGTAACATCGACGC	female
ACCGTAAGTCAGCTAT	female
ACCGTAATCACTTCAT	female
ACCGTAATCGGTTCGG	female
ACCTTTAAGATGTTAG	female
ACCTTTAAGCTGAACG	male
ACCTTTAAGGCATGGT	male
ACCTTTAAGGTGATTA	female
ACCTTTACAAACGCGA	female
ACCTTTACAGGTGGAT	male
ACCTTTACATAGAAAC	male
ACCTTTAGTGAGTATA	female
ACCTTTATCACCGGGT	female
ACCTTTATCCCTGACT	female
ACGAGCCAGCGAGAAA	male
ACGAGCCAGCGTAATA	male
ACGAGCCAGCTGTTCA	female
ACGAGCCAGGAATGGA	male
ACGAGCCAGTCAAGGC	male
ACGAGCCCAATGCCAT	male
ACGAGCCCACGAAGCA	female
ACGAGCCCAGTAAGAT	female
ACGAGCCCAGTAAGCG	male
ACGAGCCCAGTCTTCC	female
ACGAGCCGTTCTCATT	female
ACGAGCCGTTGTACAC	male
ACGAGCCTCCAGGGCT	female
ACGAGCCTCGGAAATA	female
ACGAGGAAGTGTTGAA	female
ACGAGGACAACACGCC	male
ACGAGGACAGACGCCT	male
ACGAGGACAGATGGGT	male
ACGAGGACATTTGCCC	male
ACGAGGAGTAAGGGAA	male
ACGAGGAGTACCGTTA	female
ACGAGGAGTCTAAACC	female
ACGAGGAGTTCCACGG	female
ACGAGGAGTTCCGGCA	male
ACGAGGATCAACACGT	female
ACGATACAGATCTGAA	female
ACGATACAGGTGATTA	female
ACGATACAGTTTCCTT	female
ACGATACGTCAACATC	male
ACGATACTCATTTGGG	male
ACGATGTAGCCCTAAT	male
ACGATGTAGTGACTCT	female
ACGATGTCAATAGCGG	male
ACGATGTCACAGTCGC	male
ACGATGTCACGGTTTA	male
ACGATGTGTCTAACGT	male
ACGATGTTCACCATAG	female
ACGATGTTCCAGAGGA	female
ACGATGTTCCCATTTA	male
ACGATGTTCCCTAATT	female
ACGATGTTCGGACAAG	female
ACGATGTTCTAGAGTC	male
ACGCAGCAGCAGACTG	female
ACGCAGCAGCGTTGCC	male
ACGCAGCAGGGAGTAA	female
ACGCAGCCAAGCCATT	female
ACGCAGCCAAGGTGTG	male
ACGCAGCCACAAGACG	male
ACGCAGCCAGCTGTAT	male
ACGCAGCCATCTGGTA	female
ACGCAGCGTAGAAAGG	female
ACGCAGCGTGCAACTT	male
ACGCAGCGTTAGTGGG	male
ACGCAGCGTTGATTCG	male
ACGCAGCGTTTGACTG	female
ACGCAGCTCCTCATTA	male
ACGCAGCTCGCAAGCC	female
ACGCAGCTCGCATGGC	female
ACGCCAGAGAAACGAG	female
ACGCCAGAGATGTCGG	male
ACGCCAGCACCAGTTA	male
ACGCCAGCATGGGAAC	male
ACGCCAGGTCATGCCG	male
ACGCCAGGTGAAATCA	male
ACGCCAGGTGCTGTAT	female
ACGCCAGGTTAAGACA	female
ACGCCGAAGACTGGGT	male
ACGCCGAAGCAGCGTA	male
ACGCCGAGTACATGTC	male
ACGCCGAGTCTAGAGG	female
ACGCCGAGTGGTCTCG	male
ACGCCGATCCAAGCCG	female
ACGCCGATCCCACTTG	male
ACGGAGAAGCTAGCCC	female
ACGGAGACACAGACAG	female
ACGGAGACACGTTGGC	male
ACGGAGACATTACGAC	female
ACGGAGAGTAGGGTAC	male
ACGGAGAGTCAGAATA	male
ACGGCCAAGAAGGCCT	male
ACGGCCAAGAATGTGT	female
ACGGCCAAGATGTCGG	male
ACGGCCAAGCTAGGCA	female
ACGGCCAAGTGCCATT	female
ACGGCCACAAGCTGGA	male
ACGGCCACACCGAAAG	female
ACGGCCACACGTGAGA	male
ACGGCCACATGTTGAC	female
ACGGCCAGTCGCTTCT	male
ACGGCCAGTGTAAGTA	female
ACGGCCATCAAGAAGT	female
ACGGCCATCGCCTGAG	male
ACGGGCTAGAAACCTA	female
ACGGGCTAGCGATTCT	female
ACGGGCTCAATGTTGC	male
ACGGGCTCACTTACGA	male
ACGGGCTGTGACGGTA	male
ACGGGCTTCATGCATG	female
ACGGGCTTCCAATGGT	female
ACGGGCTTCGGACAAG	male
ACGGGCTTCTTGCAAG	male
ACGGGTCAGGTGCTTT	male
ACGGGTCAGTCCATAC	female
ACGGGTCCACCCTATC	female
ACGGGTCCACGCGAAA	female
ACGGGTCCATGAAGTA	male
ACGGGTCCATGGTAGG	male
ACGGGTCGTCTTGATG	female
ACGGGTCGTGGCCCTA	male
ACGGGTCGTTACTGAC	female
ACGTCAAAGATGGGTC	male
ACGTCAAAGGTGATTA	male
ACGTCAACAAGGTTCT	female
ACGTCAACACAGGTTT	female
ACGTCAACACGACGAA	male
ACGTCAAGTCTCTCGT	female
ACGTCAATCAGTGCAT	male
ACGTCAATCCAAGTAC	male
ACTATCTAGACCCACC	male
ACTATCTAGAGGTTAT	female
ACTATCTAGATGTCGG	male
ACTATCTAGTACACCT	female
ACTATCTCAGGCGATA	male
ACTATCTCATATGCTG	male
ACTATCTCATCGTCGG	female
ACTATCTGTCCGTGAC	female
ACTATCTTCCTATTCA	female
ACTATCTTCTCGCTTG	male
ACTGAACAGCACCGTC	male
ACTGAACAGCGCCTTG	female
ACTGAACCAATGAAAC	female
ACTGAACCAGTGACAG	male
ACTGAACCATAGACTC	male
ACTGAACGTTAAGACA	male
ACTGAACGTTCCATGA	male
ACTGAACTCCTCAACC	female
ACTGAACTCTTCCTTC	male
ACTGAGTAGGAATTAC	female
ACTGAGTCAAACTGCT	female
ACTGAGTCAAGGACAC	male
ACTGAGTCACCGTTGG	female
ACTGAGTCACGGTAGA	male
ACTGAGTCACGTCTCT	male
ACTGAGTGTGTGACGA	female
ACTGAGTTCACTCCTG	male
ACTGATGAGCCAGAAC	male
ACTGATGAGCTAAACA	female
ACTGATGAGGAGTACC	female
ACTGATGAGTCATCCA	female
ACTGATGCAATGGAAT	male
ACTGATGCAATGGATA	female
ACTGATGCACCTATCC	male
ACTGATGCATGATCCA	female
ACTGATGGTCTTGCGG	female
ACTGATGGTGCAGACA	female
ACTGATGGTTTGTGTG	male
ACTGATGTCACAATGC	male
ACTGATGTCACCCGAG	female
ACTGATGTCCGCTGTT	male
ACTGATGTCGAACTGT	female
ACTGCTCAGCGTTGCC	female
ACTGCTCAGTACGCGA	female
ACTGCTCAGTGGTAAT	male
ACTGCTCAGTTATCGC	female
ACTGCTCCAAAGGAAG	female
ACTGCTCCACAGATTC	male
ACTGCTCCATCAGTCA	male
ACTGCTCGTCACCTAA	female
ACTGCTCGTGACCAAG	female
ACTGCTCTCAAGAAGT	male
ACTGCTCTCCGTCAAA	male
ACTGCTCTCGAGGTAG	female
ACTGTCCAGAGCCTAG	male
ACTGTCCAGCACCGTC	female
ACTGTCCAGCGTGAAC	female
ACTGTCCCACTGTGTA	male
ACTGTCCCATGTCGAT	male
ACTGTCCGTAGCAAAT	female
ACTGTCCGTAGCTAAA	female
ACTGTCCGTCTCAACA	male
ACTGTCCGTCTGCCAG	male
ACTGTCCGTTACAGAA	female
ACTGTCCGTTCGTGAT	male
ACTGTCCTCTTCATGT	male
ACTTACTAGACCTTTG	male
ACTTACTAGCGTCTAT	female
ACTTACTAGTTGAGAT	male
ACTTACTGTACCGCTG	female
ACTTGTTAGCTCCCAG	female
ACTTGTTAGTAGATGT	male
ACTTGTTAGTCATCCA	male
ACTTGTTCAATCACAC	male
ACTTGTTCACAGATTC	female
ACTTGTTCACCCATTC	female
ACTTGTTGTGTGGCTC	male
ACTTGTTTCACAGTAC	male
ACTTGTTTCCGGGTGT	female
ACTTGTTTCGAATCCA	male
ACTTGTTTCGGTGTCG	female
ACTTTCAAGAATGTTG	male
ACTTTCAAGATAGGAG	male
ACTTTCAAGCGAGAAA	female
ACTTTCAAGCTGCGAA	female
ACTTTCAAGGCCCGTT	male
ACTTTCAAGGTGCTAG	male
ACTTTCAAGTCATGCT	female
ACTTTCAAGTTGTAGA	female
ACTTTCAGTGCATCTA	female
ACTTTCAGTTGTGGAG	male
ACTTTCAGTTTGGGCC	male
ACTTTCATCAATCACG	male
ACTTTCATCCGCTGTT	male
ACTTTCATCGTACGGC	male
AGAATAGAGCCACGTC	male
AGAATAGAGGGAACGG	female
AGAATAGAGGTGACCA	male
AGAATAGAGTACGCCC	male
AGAATAGCAATCCGAT	female
AGAATAGCACGCCAGT	female
AGAATAGCAGCATACT	male
AGAATAGCAGCGATCC	female
AGAATAGGTCGTTGTA	male
AGAATAGGTGCTGTAT	female
AGAATAGGTTAAGAAC	female
AGAATAGTCACCAGGC	female
AGAATAGTCCGTACAA	male
AGACGTTAGTCGAGTG	male
AGACGTTCAAGTACCT	male
AGACGTTCAAGTCTGT	female
AGACGTTCAATAAGCA	male
AGACGTTCAGCTTCGG	male
AGACGTTCAGTCAGCC	male
AGACGTTCATATACGC	male
AGACGTTTCAACGGGA	female
AGACGTTTCACGCATA	female
AGACGTTTCAGCCTAA	male
AGACGTTTCATTGCGA	female
AGACGTTTCGAATGGG	female
AGACGTTTCTCATTCA	male
AGAGCGAAGACGCAAC	male
AGAGCGAAGTCAAGCG	male
AGAGCGACAACGATGG	male
AGAGCGACAAGTTCTG	female
AGAGCGACACCGAATT	male
AGAGCGACAGCATGAG	female
AGAGCGACATTTGCTT	female
AGAGCGAGTAGCTTGT	male
AGAGCGAGTATCGCAT	male
AGAGCGAGTCTACCTC	female
AGAGCGATCATTCACT	female
AGAGCGATCGAATGCT	male
AGAGCGATCTCAACTT	male
AGAGCTTAGCTGTCTA	male
AGAGCTTAGGATCGCA	female
AGAGCTTAGTTACCCA	female
AGAGCTTCAGTGGAGT	male
AGAGCTTCATCCCACT	female
AGAGCTTGTAAATACG	female
AGAGCTTGTTCCACTC	female
AGAGCTTTCAACGGGA	female
AGAGTGGAGAGTCGGT	female
AGAGTGGAGTGAAGAG	female
AGAGTGGCAATGTTGC	female
AGAGTGGCACAGACAG	female
AGAGTGGCACTCGACG	male
AGAGTGGGTCGTCTTC	female
AGAGTGGGTTAAAGAC	female
AGAGTGGTCCACGTTC	male
AGAGTGGTCCATGAAC	female
AGAGTGGTCGCCCTTA	female
AGAGTGGTCGGCGCTA	female
AGAGTGGTCGTCCAGG	female
AGAGTGGTCTCTGAGA	male
AGAGTGGTCTGCCAGG	female
AGATCTGAGCTGTTCA	male
AGATCTGCAGACGTAG	male
AGATCTGCAGTCGTGC	female
AGATCTGGTCCGAAGA	male
AGATCTGGTGACTCAT	female
AGATCTGTCAGTTAGC	female
AGATCTGTCATCACCC	female
AGATTGCAGAAACGAG	female
AGATTGCAGCCATCGC	male
AGATTGCCAGATTGCT	male
AGATTGCCATGAGCGA	female
AGATTGCGTCATGCCG	male
AGATTGCGTGTAACGG	male
AGATTGCGTTAGGGTG	male
AGATTGCTCCGTCATC	female
AGATTGCTCGAGCCCA	male
AGCAGCCAGAATAGGG	male
AGCAGCCAGACACTAA	male
AGCAGCCAGATGTAAC	male
AGCAGCCAGCTACCGC	female
AGCAGCCAGGACAGAA	male
AGCAGCCAGTATTGGA	male
AGCAGCCCAACACCCG	male
AGCAGCCGTATTCGTG	male
AGCAGCCTCCCTAACC	female
AGCAGCCTCTCTAAGG	male
AGCATACAGAGCCTAG	male
AGCATACAGTACGCGA	male
AGCATACCAATCCGAT	male
AGCATACCAATGGTCT	female
AGCATACCATCTACGA	female
AGCATACCATTGGCGC	male
AGCATACGTACAGTGG	male
AGCATACGTAGCACGA	female
AGCATACGTGCAACGA	male
AGCATACGTGTATGGG	female
AGCATACTCGTACGGC	female
AGCCTAAAGGCGCTCT	female
AGCCTAACACCTTGTC	female
AGCCTAAGTGATGCCC	female
AGCCTAATCACTTATC	male
AGCCTAATCCGCGGTA	male
AGCCTAATCCGTTGCT	female
AGCCTAATCGCGTAGC	male
AGCGGTCAGAATTCCC	male
AGCGGTCAGACTCGGA	male
AGCGGTCAGAGTGACC	female
AGCGGTCAGCGTGAGT	female
AGCGGTCAGGCGCTCT	female
AGCGGTCAGGCTAGAC	female
AGCGGTCAGGCTCTTA	male
AGCGGTCTCGCTGATA	male
AGCGGTCTCTCAACTT	male
AGCGTATAGCGTGAAC	female
AGCGTATAGCTGCCCA	male
AGCGTATCACATAACC	male
AGCGTATCACGAAATA	male
AGCGTATGTAAGGGAA	female
AGCGTATGTAAGGGCT	female
AGCGTATTCCTTTACA	female
AGCGTATTCGTGGACC	male
AGCGTATTCTGGTATG	male
AGCGTCGCAACACCTA	female
AGCGTCGCAGTGAGTG	female
AGCGTCGCATATGGTC	male
AGCGTCGGTACAGCAG	male
AGCGTCGGTTATTCTC	male
AGCGTCGGTTCGGCAC	male
AGCGTCGTCGTCCAGG	female
AGCGTCGTCTACGAGT	female
AGCTCCTAGGTGCTAG	female
AGCTCCTAGTGGTAGC	female
AGCTCCTCACAAGTAA	male
AGCTCCTCACCGATAT	female
AGCTCCTGTCCGTCAG	female
AGCTCCTGTCGGATCC	male
AGCTCCTGTCTCCCTA	male
AGCTCCTGTGAGGGAG	male
AGCTCCTGTTACGGAG	male
AGCTCCTTCACCGTAA	female
AGCTCCTTCCACGTGG	female
AGCTCCTTCCATGCTC	female
AGCTCTCCAATAAGCA	male
AGCTCTCCAATGAAAC	male
AGCTCTCCAATGTTGC	male
AGCTCTCCATCTACGA	female
AGCTCTCGTCCCTACT	female
AGCTCTCGTCTCTTAT	male
AGCTCTCGTGACGCCT	male
AGCTCTCTCTCGTTTA	male
AGCTCTCTCTCTAAGG	male
AGCTCTCTCTGGGCCA	female
AGCTTGAAGAACTCGG	male
AGCTTGAAGAGCTATA	male
AGCTTGAAGATGCCAG	male
AGCTTGAAGATGGCGT	female
AGCTTGAAGTATGACA	male
AGCTTGACAAGGCTCC	male
AGCTTGACAAGTTAAG	male
AGCTTGACACAAGACG	male
AGCTTGACACCATGTA	female
AGCTTGACAGTATCTG	male
AGCTTGAGTAGCGTCC	female
AGCTTGAGTCGGCTCA	male
AGCTTGATCCTAAGTG	male
AGCTTGATCGCCTGAG	female
AGCTTGATCTCATTCA	female
AGGCCACAGAGTAATC	male
AGGCCACAGTACGACG	male
AGGCCACAGTTGCAGG	female
AGGCCACCATACTACG	female
AGGCCACCATTAGCCA	male
AGGCCACGTGGGTATG	male
AGGCCACTCCCAAGTA	male
AGGCCGTAGCGCCTCA	male
AGGCCGTAGGAGTTGC	female
AGGCCGTAGGATATAC	female
AGGCCGTCACACGCTG	male
AGGCCGTCATCACGTA	female
AGGCCGTGTAATCGTC	male
AGGCCGTGTGGCTCCA	male
AGGCCGTGTTAAGAAC	male
AGGCCGTTCCATTCTA	female
AGGCCGTTCGACAGCC	male
AGGGAGTAGAAACCTA	male
AGGGAGTAGACTAGAT	male
AGGGAGTAGTATCTCG	male
AGGGAGTAGTCAATAG	male
AGGGAGTAGTGGTCCC	male
AGGGAGTGTAGAGCTG	male
AGGGAGTGTTGTCTTT	male
AGGGATGAGAGGGCTT	male
AGGGATGAGAGGTACC	male
AGGGATGAGATAGTCA	male
AGGGATGAGCACCGCT	male
AGGGATGAGTTTAGGA	female
AGGGATGCACCCATGG	male
AGGGATGCAGCCTGTG	male
AGGGATGCATCCGGGT	male
AGGGATGGTCCAGTGC	male
AGGGATGGTGCACTTA	female
AGGGATGGTGTAATGA	male
AGGGATGGTTATCGGT	male
AGGGATGTCCGGGTGT	male
AGGGATGTCGGTGTTA	female
AGGGATGTCTGTCCGT	male
AGGGTGAAGACCTAGG	male
AGGGTGACAGTCAGAG	male
AGGGTGATCCGTAGTA	female
AGGGTGATCTACTCAT	male
AGGGTGATCTATCGCC	male
AGGGTGATCTCGCATC	male
AGGTCATAGAGGGCTT	male
AGGTCATAGATGGGTC	male
AGGTCATAGCTAACTC	female
AGGTCATAGTAGCGGT	female
AGGTCATCAAGCCGCT	female
AGGTCATCATCCCATC	female
AGGTCCGAGAGTAAGG	male
AGGTCCGAGAGTCGGT	male
AGGTCCGCAGACGCCT	male
AGGTCCGCAGCTGCTG	female
AGGTCCGCATCCGGGT	male
AGTAGTCAGCCATCGC	male
AGTAGTCAGCCGATTT	male
AGTAGTCAGTAGTGCG	female
AGTAGTCCAAGGTTCT	male
AGTAGTCCAATGAAAC	male
AGTAGTCCACACAGAG	female
AGTAGTCCACGAAGCA	male
AGTAGTCCATGTCGAT	male
AGTAGTCCATGTTGAC	male
AGTAGTCGTCGTCTTC	female
AGTAGTCGTGATAAGT	female
AGTAGTCGTTCTGAAC	female
AGTAGTCGTTCTGGTA	female
AGTAGTCTCAATCTCT	male
AGTAGTCTCATGTCCC	male
AGTAGTCTCTTACCTA	male
AGTAGTCTCTTTACAC	female
AGTCTTTAGACGCTTT	female
AGTCTTTAGATATACG	male
AGTCTTTCATCTATGG	female
AGTCTTTCATTTCACT	female
AGTCTTTGTCAATGTC	female
AGTCTTTGTTTACTCT	female
AGTCTTTTCCCACTTG	male
AGTGAGGAGCAGGTCA	female
AGTGAGGAGGGTCGAT	male
AGTGAGGAGTAAGTAC	female
AGTGAGGCAAAGAATC	male
AGTGAGGCACGGTAGA	female
AGTGAGGCATATGGTC	female
AGTGAGGCATCGACGC	male
AGTGAGGGTCGAGTTT	male
AGTGAGGGTGATGCCC	female
AGTGAGGGTGTGGCTC	male
AGTGAGGGTTGCTCCT	female
AGTGAGGTCCGCATCT	male
AGTGAGGTCTATCCTA	female
AGTGGGAAGAACTGTA	male
AGTGGGAAGGAGCGAG	female
AGTGGGACAAAGGTGC	female
AGTGGGACACCAGTTA	female
AGTGGGAGTAGAGTGC	male
AGTGGGATCCTGCCAT	female
AGTGTCAAGATATACG	male
AGTGTCAAGGCATTGG	male
AGTGTCAAGTGACTCT	male
AGTGTCACAATGGACG	male
AGTGTCACAGGTGCCT	female
AGTGTCACAGTTCCCT	female
AGTGTCAGTAGCTTGT	female
AGTGTCAGTCAAAGAT	female
AGTGTCAGTTAAAGTG	male
AGTGTCAGTTAGAACA	male
AGTGTCATCAGGCCCA	male
AGTTGGTAGAGTAAGG	male
AGTTGGTCAGCTTCGG	female
AGTTGGTCAGTTAACC	male
AGTTGGTCATAAGACA	female
AGTTGGTGTACGAAAT	male
AGTTGGTGTAGCTTGT	female
AGTTGGTGTATAAACG	female
AGTTGGTGTCATGCAT	male
AGTTGGTGTCGACTGC	male
AGTTGGTGTCGCTTTC	female
AGTTGGTGTGACGCCT	female
AGTTGGTGTTGCTCCT	male
AGTTGGTTCACGATGT	male
AGTTGGTTCCTAGAAC	female
AGTTGGTTCGATAGAA	female
AGTTGGTTCGGAGGTA	male
AGTTGGTTCTGCTGCT	female
ATAACGCAGCCCAATT	female
ATAACGCAGGTAGCTG	female
ATAACGCAGTCTTGCA	male
ATAACGCCAATTCCTT	male
ATAACGCCACTGAAGG	female
ATAACGCCATATACCG	male
ATAACGCCATCACAAC	female
ATAACGCGTATCGCAT	female
ATAACGCGTCCAGTAT	male
ATAACGCGTCGTCTTC	female
ATAACGCTCAGGTAAA	female
ATAAGAGAGAAGGTTT	male
ATAAGAGAGCTAGTCT	male
ATAAGAGAGGATGTAT	female
ATAAGAGCAATGACCT	male
ATAAGAGCAGAGTGTG	male
ATAAGAGTCAGCAACT	female
ATAGACCAGTCCAGGA	male
ATAGACCCAGTAAGAT	male
ATAGACCGTATCTGCA	male
ATAGACCGTTACCAGT	male
ATAGACCTCACTCTTA	female
ATCACGAAGAGTGACC	female
ATCACGAAGATGCGAC	male
ATCACGACACTCAGGC	male
ATCACGACAGCTGCAC	female
ATCACGACAGTTTACG	female
ATCACGACATCCCATC	female
ATCACGAGTATGCTTG	female
ATCACGAGTCAACTGT	female
ATCACGATCGTCACGG	female
ATCACGATCTACCAGA	male
ATCATCTAGAAGGCCT	male
ATCATCTCAGCCTTTC	female
ATCATCTCAGTAACGG	male
ATCATCTCAGTGGGAT	female
ATCATCTGTACTCGCG	male
ATCATCTGTATTACCG	female
ATCATCTGTGTAACGG	male
ATCATCTGTTGGTTTG	female
ATCATCTTCATCGGAT	female
ATCATCTTCGATGAGG	male
ATCATCTTCGTCGTTC	female
ATCATGGAGAGTCGGT	male
ATCATGGAGGTGATTA	female
ATCATGGCAACGATCT	female
ATCATGGCAAGACACG	male
ATCATGGCAATCGAAA	male
ATCATGGGTAGGCATG	female
ATCATGGGTGAGCGAT	male
ATCATGGTCCCTTGTG	male
ATCATGGTCCGTCAAA	male
ATCATGGTCCTTGGTC	male
ATCCACCCAACTGGCC	male
ATCCACCGTATTACCG	female
ATCCACCGTCAGAATA	female
ATCCACCGTTAGGGTG	female
ATCCACCTCTATCCCG	male
ATCCGAAAGCAATATG	male
ATCCGAAAGTATTGGA	female
ATCCGAAAGTTAGCGG	male
ATCCGAACAATCGGTT	male
ATCCGAACAATGACCT	female
ATCCGAAGTCGGGTCT	male
ATCCGAAGTCTCGTTC	female
ATCCGAAGTGCACGAA	male
ATCCGAAGTGTAAGTA	male
ATCCGAATCAAAGTAG	female
ATCCGAATCAGCTCTC	male
ATCCGAATCCAACCAA	female
ATCCGAATCCGCAGTG	male
ATCGAGTAGCCGGTAA	female
ATCGAGTAGCCTATGT	female
ATCGAGTAGCTAACTC	female
ATCGAGTAGTAGATGT	male
ATCGAGTCAAACGTGG	female
ATCGAGTGTAGAGTGC	female
ATCGAGTGTTCGTTGA	female
ATCGAGTTCAACACTG	male
ATCGAGTTCATACGGT	male
ATCGAGTTCCACTGGG	male
ATCGAGTTCCGCGGTA	female
ATCTACTAGACAGGCT	female
ATCTACTAGATATGGT	female
ATCTACTAGGGATGGG	female
ATCTACTAGGGTTTCT	female
ATCTACTGTCTCTCTG	male
ATCTACTGTGCGATAG	male
ATCTACTGTTAAGATG	female
ATCTACTTCAACACAC	female
ATCTACTTCGCTAGCG	female
ATCTACTTCTCTAAGG	female
ATCTACTTCTCTGCTG	female
ATCTGCCAGAAAGTGG	female
ATCTGCCAGACAGGCT	male
ATCTGCCAGCAATATG	male
ATCTGCCCAAGCGCTC	male
ATCTGCCCACCGTTGG	female
ATCTGCCCAGGATCGA	female
ATCTGCCGTATCACCA	male
ATCTGCCGTCAGATAA	male
ATCTGCCGTCCAGTTA	female
ATCTGCCTCCCAACGG	male
ATCTGCCTCGCGGATC	male
ATCTGCCTCGCGTAGC	female
ATGAGGGAGACAATAC	male
ATGAGGGAGACAGACC	male
ATGAGGGAGACTTTCG	male
ATGAGGGAGGACACCA	male
ATGAGGGCAACTGCGC	female
ATGAGGGCAAGTTGTC	female
ATGAGGGCAATGACCT	male
ATGAGGGCACAACTGT	female
ATGAGGGCAGATCGGA	male
ATGAGGGCAGGTGCCT	female
ATGAGGGGTCAGAGGT	female
ATGAGGGGTGTGACCC	male
ATGAGGGTCAACGCTA	female
ATGAGGGTCAGTACGT	male
ATGAGGGTCCATGAGT	male
ATGAGGGTCCATGCTC	female
ATGCGATAGAAACGAG	female
ATGCGATAGAAGGTTT	male
ATGCGATAGACGCTTT	male
ATGCGATAGATATGCA	female
ATGCGATCACCTTGTC	female
ATGCGATCATAGTAAG	male
ATGCGATGTGGGTATG	male
ATGCGATGTTATTCTC	female
ATGCGATTCCCTGACT	male
ATGCGATTCGTTTGCC	male
ATGGGAGAGAATAGGG	male
ATGGGAGAGAGCAATT	male
ATGGGAGAGATAGCAT	male
ATGGGAGAGCTGATAA	female
ATGGGAGCAAGCCGCT	female
ATGGGAGCAATGCCAT	male
ATGGGAGCACCACCAG	female
ATGGGAGCAGATCCAT	male
ATGGGAGCATGACATC	male
ATGGGAGCATGTCGAT	male
ATGGGAGGTAGTGAAT	male
ATGGGAGGTATAGGGC	male
ATGGGAGGTCTCTTTA	female
ATGGGAGGTTGACGTT	male
ATGGGAGTCGTAGGAG	female
ATGGGAGTCTGCGACG	female
ATGTGTGAGGTCGGAT	female
ATGTGTGAGTAATCCC	female
ATGTGTGAGTGAAGAG	male
ATGTGTGAGTGTGGCA	male
ATGTGTGAGTTACGGG	female
ATGTGTGCAAGCGCTC	male
ATGTGTGCAAGTTGTC	female
ATGTGTGCAGACAAGC	female
ATGTGTGTCCGGGTGT	female
ATTACTCAGGATGTAT	male
ATTACTCAGTACGCCC	female
ATTACTCCACACAGAG	female
ATTACTCCACGAAACG	male
ATTACTCCACGGCCAT	female
ATTACTCCATCACGAT	male
ATTACTCTCACGCATA	male
ATTACTCTCCGCAAGC	male
ATTATCCAGACCTTTG	male
ATTATCCAGCGATAGC	male
ATTATCCCAATAGCGG	male
ATTATCCGTTCCACAA	male
ATTATCCTCACATAGC	male
ATTCTACAGCAGCCTC	male
ATTCTACAGCGTGAGT	male
ATTCTACCAGCGATCC	male
ATTCTACGTGGTAACG	male
ATTCTACGTTAGATGA	male
ATTCTACTCAGCACAT	male
ATTCTACTCATGCTCC	female
ATTCTACTCCCATTAT	female
ATTCTACTCTCTAAGG	male
ATTGGACAGGACAGAA	female
ATTGGACAGGGCTTGA	male
ATTGGACCAAACTGCT	female
ATTGGACCAATACGCT	female
ATTGGACGTGACAAAT	female
ATTGGACGTGAGGGAG	male
ATTGGACGTTGCGTTA	male
ATTGGACTCTTGTCAT	female
ATTGGTGAGGCCCTCA	male
ATTGGTGAGTACGATA	male
ATTGGTGCAATCTACG	male
ATTGGTGCAGCGTCCA	male
ATTGGTGCAGTAAGAT	male
ATTGGTGGTAGCGTCC	female
ATTGGTGTCCCTCAGT	male
ATTGGTGTCGGTTCGG	female
ATTGGTGTCGTACGGC	male
ATTTCTGAGAGTACAT	male
ATTTCTGAGGATCGCA	female
ATTTCTGAGTCAATAG	male
ATTTCTGCAATGCCAT	male
ATTTCTGCAGTTTACG	male
ATTTCTGCATGTAGTC	female
ATTTCTGGTGACAAAT	male
ATTTCTGTCCGAGCCA	male
ATTTCTGTCTTGAGGT	male
ATTTCTGTCTTTAGTC	male
CAACCAAAGACCCACC	male
CAACCAAAGGTAAACT	female
CAACCAACACTTAAGC	male
CAACCAACAGTGAGTG	male
CAACCAAGTTATCACG	female
CAACCAATCAGGCCCA	female
CAACCAATCAGTGTTG	female
CAACCAATCGTGGACC	male
CAACCAATCTGGGCCA	female
CAACCTCAGCACAGGT	male
CAACCTCAGTCAAGGC	female
CAACCTCCAATGGTCT	female
CAACCTCGTCAAAGCG	male
CAACCTCGTCGAGTTT	female
CAACCTCGTTCAACCA	female
CAACCTCTCCGCGCAA	female
CAACCTCTCGCCTGAG	female
CAACTAGAGCCAGAAC	female
CAACTAGAGTGTGAAT	female
CAACTAGGTATATGGA	male
CAACTAGGTCAGAGGT	male
CAACTAGTCACCACCT	male
CAACTAGTCAGCGACC	female
CAACTAGTCCCTGACT	female
CAACTAGTCGGTGTCG	female
CAAGAAAAGTGTACTC	female
CAAGAAACAGCGTAAG	female
CAAGAAACATGTCCTC	female
CAAGATCAGTGAAGTT	female
CAAGATCCACCTCGGA	female
CAAGATCCACTGTTAG	male
CAAGATCCAGGTTTCA	male
CAAGATCGTCAGATAA	male
CAAGATCGTCATCGGC	female
CAAGATCTCACAGGCC	male
CAAGATCTCATCGCTC	female
CAAGATCTCGGAGCAA	female
CAAGATCTCTATCCCG	male
CAAGATCTCTGTCAAG	female
CAAGGCCAGAATAGGG	female
CAAGGCCAGACCTTTG	female
CAAGGCCAGTCCTCCT	female
CAAGGCCCATTTCACT	female
CAAGGCCGTCGTCTTC	female
CAAGGCCGTCTGCCAG	male
CAAGGCCGTGACAAAT	female
CAAGGCCGTTAAGGGC	male
CAAGGCCTCCTATGTT	male
CAAGTTGAGACTACAA	female
CAAGTTGAGTGGAGAA	female
CAAGTTGAGTTAGGTA	female
CAAGTTGCAATCGGTT	female
CAAGTTGCACAGATTC	male
CAAGTTGCAGACGTAG	male
CAAGTTGCAGTGGGAT	male
CAAGTTGCATCAGTAC	female
CAAGTTGGTTCTCATT	female
CAAGTTGGTTTGACTG	female
CAAGTTGTCATCGATG	male
CAAGTTGTCGCCATAA	male
CACAAACCAACACCCG	male
CACAAACCACCAGATT	male
CACAAACCAGGAATGC	female
CACAAACCATTGGTAC	female
CACAAACGTCATTAGC	male
CACAAACGTCTAAACC	male
CACAAACGTTCCACAA	female
CACAAACGTTGAGGTG	male
CACAAACTCGGATGTT	male
CACAAACTCTGGTGTA	female
CACACAAAGAGATGAG	male
CACACAAAGCCACGCT	male
CACACAAAGGGAGTAA	male
CACACAAAGTCAATAG	female
CACACAAAGTGTTGAA	male
CACACAACAAGCGATG	female
CACACAACAGGAATCG	female
CACACAACAGTTCCCT	female
CACACAACATGAAGTA	male
CACACAAGTTATCCGA	female
CACACAATCAGCTGGC	male
CACACAATCTATGTGG	female
CACACAATCTGTTTGT	male
CACACCTAGCCTATGT	male
CACACCTAGCGTTCCG	female
CACACCTAGGCCCTTG	male
CACACCTCAGGTCCAC	male
CACACCTCAGTAACGG	male
CACACCTGTAGGGTAC	male
CACACCTGTCTAGCCG	female
CACACCTTCACTCTTA	male
CACACCTTCCACGCAG	female
CACACCTTCCATGCTC	male
CACACCTTCTGCCCTA	male
CACACTCAGGTGACCA	female
CACACTCAGTGTTGAA	female
CACACTCGTCAATACC	male
CACACTCGTCCAGTTA	female
CACACTCGTCCGACGT	female
CACACTCGTCGACTAT	female
CACACTCTCATACGGT	female
CACAGGCAGAGACTAT	male
CACAGGCCAAGTAATG	male
CACAGGCCAGCCTGTG	male
CACAGGCGTCATATCG	male
CACAGGCGTCGGCTCA	male
CACAGGCGTGCTAGCC	female
CACAGGCGTGTTTGTG	male
CACAGGCTCACGATGT	male
CACAGGCTCCACGAAT	female
CACAGGCTCGGAATCT	male
CACAGTAAGAAGGGTA	male
CACAGTAAGAATTCCC	female
CACAGTAAGACTTGAA	male
CACAGTACAGCTGCAC	male
CACAGTACATGGTAGG	male
CACAGTAGTATCACCA	female
CACAGTAGTGAGGCTA	female
CACAGTAGTGCAGTAG	male
CACAGTATCAGCAACT	male
CACATAGAGCAGCCTC	male
CACATAGAGGTGCTTT	male
CACATAGAGTATCTCG	female
CACATAGCATGGATGG	male
CACATAGGTTAAGACA	male
CACATAGGTTTAAGCC	male
CACATAGTCCATGAAC	male
CACATTTAGATGTTAG	female
CACATTTAGTGGCACA	male
CACATTTCACATTTCT	female
CACATTTGTCCGTCAG	male
CACATTTGTCGCATCG	male
CACATTTGTTACGTCA	male
CACATTTGTTCATGGT	male
CACCACTAGATATACG	male
CACCACTAGCTGTCTA	male
CACCACTAGTACACCT	male
CACCACTCAGGGTATG	female
CACCACTCATGGAATA	male
CACCACTGTACCGGCT	male
CACCACTTCACGCATA	female
CACCACTTCCTGCCAT	male
CACCACTTCGCAAACT	male
CACCACTTCGGTCTAA	male
CACCAGGAGCGTCAAG	female
CACCAGGAGGATGGAA	female
CACCAGGCAACTTGAC	female
CACCAGGCACGTTGGC	female
CACCAGGCAGATTGCT	female
CACCAGGCATATACGC	female
CACCAGGGTGCGGTAA	male
CACCAGGGTTATGTGC	female
CACCAGGGTTCAGTAC	female
CACCAGGGTTCCGTCT	female
CACCAGGTCGAGAGCA	male
CACCAGGTCGCTTAGA	male
CACCAGGTCGGTCCGA	male
CACCTTGAGGCCATAG	female
CACCTTGAGGCTATCT	male
CACCTTGCAACAACCT	female
CACCTTGCAATGGTCT	male
CACCTTGCATCTACGA	female
CACCTTGCATGGAATA	male
CACCTTGGTACAGTGG	male
CACCTTGGTATAAACG	male
CACCTTGGTGTATGGG	male
CACCTTGTCTTTACGT	male
CACTCCAAGCCATCGC	male
CACTCCAAGGCATGGT	male
CACTCCACAATCGAAA	female
CACTCCACACCAGGTC	male
CACTCCATCAGTGTTG	male
CACTCCATCGGAAATA	male
CACTCCATCGGCTACG	male
CACTCCATCTGGGCCA	female
CAGAATCAGAGGACGG	male
CAGAATCAGTCCGTAT	male
CAGAATCCAAACGTGG	female
CAGAATCCAAAGTGCG	female
CAGAATCGTACGAAAT	male
CAGAATCGTGCCTGGT	male
CAGAATCTCAAGAAGT	male
CAGAATCTCTGCTGTC	female
CAGAGAGAGCGATATA	female
CAGAGAGAGTTTCCTT	female
CAGAGAGCAAGCCTAT	female
CAGAGAGCACCTTGTC	female
CAGAGAGCATGCTGGC	male
CAGAGAGCATGGTTGT	male
CAGAGAGGTCGCTTTC	male
CAGAGAGTCGCGATCG	female
CAGAGAGTCGGTCCGA	female
CAGAGAGTCTGCCAGG	male
CAGAGAGTCTTTACGT	male
CAGATCAAGGGTATCG	female
CAGATCAAGTCGCCGT	female
CAGATCACACGTCAGC	female
CAGATCACAGCGTCCA	female
CAGATCAGTAGCGTAG	male
CAGATCAGTCTTCAAG	male
CAGATCAGTTTGTTTC	male
CAGATCATCTAACGGT	female
CAGATCATCTCGTATT	male
CAGCAGCCAAACAACA	male
CAGCAGCCAGTATAAG	female
CAGCAGCCATATGCTG	female
CAGCAGCGTTCCATGA	male
CAGCATAAGAATGTGT	male
CAGCATAAGGACGAAA	female
CAGCATACAGGAATGC	female
CAGCATAGTACTCGCG	male
CAGCATAGTAGGCTGA	male
CAGCATATCAAGAAGT	male
CAGCATATCGAGAACG	male
CAGCCGAAGGAATCGC	female
CAGCCGAAGGTAGCCA	female
CAGCCGAAGTCGATAA	male
CAGCCGACAATGAAAC	male
CAGCCGACAATGCCAT	male
CAGCCGACACAGCCCA	male
CAGCCGACATGCATGT	male
CAGCCGACATTCTTAC	female
CAGCCGAGTCTAGGTT	male
CAGCCGATCCGTACAA	female
CAGCCGATCTCCTATA	female
CAGCGACAGTCAAGCG	male
CAGCGACAGTTCGCGC	male
CAGCGACCAAGTCTGT	female
CAGCGACCAGACGTAG	male
CAGCGACGTCTTCAAG	female
CAGCGACTCAGTTCGA	female
CAGCTAAAGACGCAAC	female
CAGCTAAAGGCGTACA	male
CAGCTAAAGGCTCATT	female
CAGCTAAAGTGAACAT	male
CAGCTAACAAGCTGGA	female
CAGCTAACACGGTTTA	female
CAGCTAACATCCGCGA	female
CAGCTAAGTACGACCC	male
CAGCTAAGTCCGAAGA	female
CAGCTAATCGTTGACA	male
CAGCTAATCTTGCCGT	female
CAGCTGGAGAAACCGC	female
CAGCTGGAGTTAGGTA	female
CAGCTGGCAAAGTGCG	male
CAGCTGGCAAGTCTGT	female
CAGCTGGCAGGATCGA	male
CAGCTGGCAGGTTTCA	male
CAGCTGGGTTTGACAC	female
CAGCTGGTCTGGGCCA	female
CAGGTGCAGCGATGAC	female
CAGGTGCAGGACAGCT	female
CAGGTGCAGTTAAGTG	female
CAGGTGCCATATGCTG	male
CAGGTGCCATGCTAGT	male
CAGGTGCGTCGAATCT	male
CAGGTGCGTCTAAAGA	female
CAGGTGCGTGTAATGA	female
CAGGTGCGTTCGCTAA	female
CAGGTGCTCAACACTG	female
CAGGTGCTCCATGCTC	female
CAGGTGCTCGATGAGG	male
CAGTAACAGAGAACAG	female
CAGTAACAGGATTCGG	male
CAGTAACCACCACGTG	male
CAGTAACGTATTACCG	female
CAGTAACGTGCTAGCC	male
CAGTAACTCCGTACAA	male
CAGTAACTCTGCGGCA	female
CAGTCCTAGACTGTAA	male
CAGTCCTAGGACAGAA	male
CAGTCCTAGTGGAGAA	female
CAGTCCTCAAACTGTC	male
CAGTCCTGTAGCTTGT	male
CAGTCCTGTAGGAGTC	female
CAGTCCTGTCGATTGT	female
CAGTCCTGTGTCAATC	male
CAGTCCTGTGTGCGTC	female
CAGTCCTTCACGATGT	female
CAGTCCTTCTGGTGTA	female
CATATGGAGTGCCATT	male
CATATGGCAACACCTA	female
CATATGGCAAGTCATC	female
CATATGGGTTAAGGGC	male
CATATGGTCGTCGTTC	male
CATATGGTCTTGCCGT	male
CATATGGTCTTGTATC	female
CATATTCAGCGTTGCC	male
CATATTCAGGGCACTA	female
CATATTCAGTGTTGAA	female
CATATTCCAGGGATTG	female
CATATTCGTCTAGCCG	male
CATATTCGTGCAGTAG	male
CATATTCGTTTAAGCC	male
CATATTCGTTTCCACC	male
CATATTCTCGTACCGG	female
CATCAAGAGAGGTAGA	male
CATCAAGAGTAGTGCG	male
CATCAAGCAAACCCAT	female
CATCAAGCAGCCACCA	female
CATCAAGCAGGTCGTC	male
CATCAAGTCTACTATC	female
CATCAGAAGACTGTAA	male
CATCAGAAGCATCATC	male
CATCAGAAGCGTCAAG	male
CATCAGAAGTGTACGG	male
CATCAGAAGTTACCCA	female
CATCAGACAAACTGCT	male
CATCAGACAGACGTAG	female
CATCAGACATTGGGCC	female
CATCAGAGTCCGAATT	female
CATCAGAGTCGTGGCT	female
CATCAGAGTCTAAAGA	female
CATCAGAGTTCACCTC	female
CATCAGATCATAAAGG	male
CATCAGATCCCTCAGT	male
CATCAGATCCTTGACC	female
CATCAGATCTGAGGGA	male
CATCCACAGTGGGATC	female
CATCCACCAAGCTGGA	male
CATCCACCACCAACCG	male
CATCCACGTACCGGCT	female
CATCCACGTCCGAAGA	male
CATCCACGTTAAAGTG	female
CATCCACTCTCTGCTG	female
CATCCACTCTGTCCGT	male
CATCGAAAGCCAGTAG	male
CATCGAAAGGAGCGTT	female
CATCGAACAATGGAAT	female
CATCGAACACAACTGT	male
CATCGAACACAGGAGT	male
CATCGAACACCTCGTT	female
CATCGAACAGACTCGC	male
CATCGAACAGCTGCTG	male
CATCGAAGTATAATGG	female
CATCGAAGTTATGTGC	male
CATCGAATCGTCTGAA	female
CATCGAATCTTAACCT	female
CATCGGGCACCAGATT	female
CATCGGGGTAACGTTC	female
CATCGGGGTCCAGTTA	female
CATCGGGGTCTGCGGT	male
CATCGGGTCAGTTCGA	female
CATCGGGTCTCAAGTG	male
CATGACAAGCAGCGTA	female
CATGACAAGGCCCTTG	female
CATGACAAGGGTTTCT	male
CATGACATCCATTCTA	female
CATGACATCGTTACAG	male
CATGCCTAGCGCCTTG	female
CATGCCTCACGGCCAT	female
CATGCCTCAGCCTTTC	female
CATGCCTGTATCTGCA	male
CATGCCTGTCTTGTCC	female
CATGCCTGTGCAACGA	female
CATGCCTGTTATTCTC	male
CATGCCTTCAACACAC	female
CATGCCTTCAAGATCC	male
CATGCCTTCTCAACTT	female
CATGCCTTCTTCAACT	male
CATGGCGAGCATCATC	female
CATGGCGCACCGGAAA	male
CATGGCGCATCTACGA	male
CATGGCGGTATAGTAG	female
CATGGCGTCACCTCGT	female
CATTATCAGACTTTCG	male
CATTATCAGATCACGG	female
CATTATCAGATCTGCT	female
CATTATCAGTCTCAAC	female
CATTATCCAGCCAATT	male
CATTATCCAGTTCCCT	female
CATTATCGTAAAGGAG	female
CATTATCTCATCGGAT	female
CATTATCTCCTTGGTC	female
CATTATCTCGCGGATC	male
CATTATCTCTTGCATT	female
CATTCGCAGATGCGAC	female
CATTCGCAGGGTCTCC	female
CATTCGCCAAAGTGCG	female
CATTCGCGTAGCCTCG	male
CATTCGCGTCCTAGCG	female
CATTCGCGTGTTGAGG	male
CATTCGCGTTCCCTTG	male
CATTCGCTCATACGGT	male
CATTCGCTCCACGCAG	female
CATTCGCTCTAACCGA	male
CATTCGCTCTCTGTCG	female
CCAATCCAGGTGGGTT	male
CCAATCCGTGTGACCC	female
CCAATCCGTTTAGCTG	male
CCACCTACAATAAGCA	female
CCACCTAGTATCTGCA	female
CCACCTAGTGATGCCC	male
CCACCTATCAACGGCC	female
CCACCTATCATGCATG	male
CCACGGAGTATATGAG	male
CCACGGAGTCCGTTAA	female
CCACGGAGTCTAACGT	male
CCACGGATCAAGGTAA	male
CCACGGATCACATAGC	female
CCACGGATCACTTATC	male
CCACTACAGAGACTAT	male
CCACTACCAGGTGCCT	female
CCACTACCAGTCAGAG	female
CCACTACCATCCTAGA	male
CCACTACGTACATGTC	male
CCACTACGTTGAACTC	female
CCAGCGACAAATACAG	female
CCAGCGACATGCCTAA	male
CCAGCGAGTAGGCATG	male
CCAGCGAGTATAGTAG	female
CCAGCGAGTGCGCTTG	female
CCAGCGAGTTCACGGC	male
CCAGCGATCGAATCCA	male
CCAGCGATCTCAACTT	male
CCAGCGATCTGCCCTA	male
CCATGTCAGATCCGAG	female
CCATGTCAGCCGGTAA	male
CCATGTCGTACCGGCT	male
CCATGTCGTCCTCTTG	female
CCATGTCGTCGCTTTC	female
CCATGTCTCCCTGACT	male
CCATGTCTCCCTTGTG	male
CCATGTCTCTAGCACA	male
CCATGTCTCTCTGCTG	female
CCATTCGAGATCGATA	female
CCATTCGAGCACAGGT	female
CCATTCGCACAAGCCC	male
CCATTCGCATAGACTC	female
CCATTCGGTGGTCCGT	female
CCATTCGGTTCCTCCA	female
CCATTCGTCGACCAGC	female
CCATTCGTCGAGGTAG	female
CCCAATCAGACTGGGT	male
CCCAATCCACGAGAGT	male
CCCAATCCAGAGTGTG	female
CCCAATCGTACACCGC	female
CCCAATCTCGCCTGAG	male
CCCAGTTAGAGCTATA	female
CCCAGTTAGTGGTAGC	male
CCCAGTTCACCAGCAC	male
CCCAGTTCACTAAGTC	male
CCCAGTTCAGGGCATA	male
CCCAGTTCATCCGGGT	male
CCCAGTTCATCTCGCT	female
CCCAGTTGTCAATACC	female
CCCAGTTGTCTAGAGG	male
CCCAGTTGTGTGCGTC	male
CCCAGTTTCATGCTCC	male
CCCAGTTTCCAGAGGA	male
CCCAGTTTCTACTCAT	male
CCCAGTTTCTCTGAGA	female
CCCAGTTTCTTACCTA	female
CCCATACAGAAACCGC	female
CCCATACCACGGCCAT	female
CCCATACCACGTGAGA	male
CCCATACCACTATCTT	male
CCCATACGTCATGCAT	female
CCCATACGTCCGACGT	male
CCCATACGTTATGTGC	male
CCCATACGTTCGCTAA	male
CCCATACTCATTATCC	male
CCCATACTCTTATCTG	female
CCCTCCTAGACTCGGA	male
CCCTCCTAGAGACTTA	male
CCCTCCTAGAGCCTAG	male
CCCTCCTAGGTGATAT	male
CCCTCCTCAGTATAAG	male
CCCTCCTGTTGAACTC	male
CCGGGATAGAGGTTAT	female
CCGGGATCAACACCTA	male
CCGGGATCAATCCAAC	male
CCGGGATCACAGTCGC	female
CCGGGATCACTAAGTC	female
CCGGGATCAGCTCCGA	male
CCGGGATCAGGAATGC	female
CCGGGATCATAAGACA	female
CCGGGATGTCCGACGT	male
CCGGGATGTGTGGTTT	male
CCGGGATGTTACAGAA	male
CCGGGATGTTTGGGCC	male
CCGGGATTCCCATTAT	male
CCGGGATTCGCCAGCA	female
CCGGGATTCGGCGGTT	male
CCGGGATTCTTGTATC	male
CCGGTAGAGACACGAC	male
CCGGTAGAGCAGATCG	female
CCGGTAGAGCTACCTA	male
CCGGTAGAGGCTACGA	male
CCGGTAGCAGGTCCAC	male
CCGGTAGCAGTATAAG	female
CCGGTAGGTATAGGTA	male
CCGGTAGGTCTGATCA	male
CCGGTAGGTGATGTCT	female
CCGGTAGTCATGCATG	female
CCGGTAGTCCAAGTAC	male
CCGGTAGTCTACGAGT	female
CCGGTAGTCTGAAAGA	female
CCGGTAGTCTGCTGCT	male
CCGGTAGTCTGTCAAG	male
CCGTACTAGCGCTCCA	male
CCGTACTAGCTAAACA	male
CCGTACTAGTCGATAA	female
CCGTACTCACACATGT	female
CCGTACTCACAGGAGT	female
CCGTACTCAGTGACAG	male
CCGTACTCATACAGCT	female
CCGTACTGTAACGCGA	female
CCGTACTGTTCGAATC	female
CCGTACTGTTGGTGGA	female
CCGTACTTCGGCTACG	male
CCGTACTTCGGGAGTA	female
CCGTACTTCGTCGTTC	male
CCGTACTTCTCCCTGA	female
CCGTGGAAGACAAGCC	female
CCGTGGAAGGTGACCA	male
CCGTGGAAGTACGCCC	male
CCGTGGACACAACGCC	male
CCGTGGACACCATGTA	male
CCGTGGACATCGGAAG	female
CCGTGGAGTCGAACAG	female
CCGTGGATCAGGCCCA	male
CCGTGGATCCGATATG	male
CCGTGGATCGCCAGCA	female
CCGTGGATCTTCAACT	female
CCGTTCAAGAAGGACA	female
CCGTTCACACTGCCAG	female
CCGTTCACAGAGCCAA	female
CCGTTCACATGCAACT	male
CCGTTCAGTCTAGGTT	female
CCGTTCAGTCTCCATC	male
CCGTTCAGTGAGTATA	female
CCGTTCATCATTATCC	male
CCTAAAGAGGTCGGAT	male
CCTAAAGCAACGATGG	female
CCTAAAGCAAGACGTG	male
CCTAAAGCACTAAGTC	female
CCTAAAGCATAGTAAG	male
CCTAAAGGTGAGGGAG	male
CCTAAAGGTTTAAGCC	male
CCTAAAGTCCGCGCAA	female
CCTAAAGTCGGATGTT	male
CCTAAAGTCGTCTGAA	male
CCTAAAGTCGTGGGAA	male
CCTACACCAAGTAGTA	male
CCTACACCACTCTGTC	male
CCTACACCAGATGGCA	female
CCTACACCATGTAAGA	male
CCTACACGTACCGGCT	male
CCTACACGTGACTCAT	male
CCTACACGTTGATTCG	male
CCTACACTCAGCAACT	male
CCTACACTCAGCTGGC	female
CCTACACTCCTATGTT	male
CCTACACTCCTGTAGA	female
CCTACCAAGCGGCTTC	female
CCTACCACAGCTCGAC	male
CCTACCACAGTAAGCG	male
CCTACCACATCCTTGC	male
CCTACCAGTGATAAAC	female
CCTACCATCAGGTAAA	female
CCTACCATCTGCGGCA	male
CCTAGCTAGCCCAACC	male
CCTAGCTAGCTACCTA	female
CCTAGCTCAGCCACCA	male
CCTAGCTCATACGCCG	female
CCTAGCTGTAAGAGGA	female
CCTAGCTGTCCGTTAA	female
CCTAGCTGTTGTGGCC	male
CCTAGCTTCAAAGTAG	female
CCTAGCTTCACCTTAT	male
CCTAGCTTCCATGAAC	female
CCTAGCTTCTTAGAGC	female
CCTATTAAGAGGACGG	male
CCTATTACACAGTCGC	female
CCTATTACACCTGGTG	male
CCTATTACACGCGAAA	male
CCTATTAGTACTTAGC	male
CCTATTAGTTAAGAAC	female
CCTATTATCATGCTCC	female
CCTATTATCATTGCGA	female
CCTATTATCGTGTAGT	male
CCTATTATCTGTCAAG	female
CCTCAGTAGAAGGGTA	female
CCTCAGTAGCACGCCT	male
CCTCAGTCACGAGGTA	female
CCTCAGTCAGTCGATT	male
CCTCAGTCATGGTAGG	male
CCTCAGTCATTTGCTT	male
CCTCAGTGTTCCACTC	male
CCTCAGTGTTTCCACC	female
CCTCAGTGTTTGTTGG	male
CCTCTGAAGCGAGAAA	male
CCTCTGAAGTTCGATC	female
CCTCTGACAGTATGCT	female
CCTCTGACATGCAATC	female
CCTCTGAGTGTTCTTT	male
CCTCTGATCGAGCCCA	male
CCTTACGAGACATAAC	male
CCTTACGAGGGTTCCC	female
CCTTACGAGGTGCAAC	female
CCTTACGAGGTGTGGT	male
CCTTACGCACAGCGTC	male
CCTTACGCACGAGGTA	female
CCTTACGCACGCCAGT	male
CCTTACGCAGCCAGAA	male
CCTTACGCATGTCTCC	female
CCTTACGGTCGCATCG	female
CCTTACGGTCTGATCA	male
CCTTACGTCCGCGGTA	female
CCTTCCCAGTCAATAG	female
CCTTCCCGTAAAGTCA	female
CCTTCCCGTACCGTAT	female
CCTTCCCGTACGACCC	female
CCTTCCCGTTAAGACA	male
CCTTCCCTCACGCATA	male
CCTTCGAAGATAGGAG	female
CCTTCGAAGCTCCCAG	female
CCTTCGACACCGAATT	male
CCTTCGACACGGTTTA	female
CCTTCGACAGTTTACG	male
CCTTCGACATATACCG	female
CCTTCGACATCGACGC	male
CCTTCGAGTCTCTTAT	female
CCTTCGATCCAATGGT	female
CCTTCGATCGTCCAGG	male
CCTTCGATCTAACCGA	male
CCTTTCTAGAGCTATA	female
CCTTTCTAGCTAGTTC	female
CCTTTCTCAACACCCG	female
CCTTTCTCAGTTCATG	female
CCTTTCTCATGCTAGT	male
CCTTTCTGTATTCTCT	female
CCTTTCTGTCGACTGC	male
CGAACATAGAGCCCAA	male
CGAACATAGCACCGCT	male
CGAACATAGCGGCTTC	female
CGAACATCACAGCCCA	female
CGAACATCACGCATCG	female
CGAACATCACTATCTT	male
CGAACATCAGATGGCA	female
CGAACATCATGACATC	female
CGAACATGTACCGTAT	male
CGAACATTCACCACCT	female
CGAACATTCACTATTC	male
CGAACATTCGTCGTTC	male
CGAACATTCTCTTGAT	male
CGAACATTCTGGTGTA	male
CGAATGTAGAGAGCTC	female
CGAATGTCAATACGCT	female
CGAATGTCAGACGCAA	female
CGAATGTCAGCTGTTA	male
CGAATGTCAGGGCATA	male
CGAATGTCAGTACACT	male
CGAATGTGTAAATGAC	male
CGAATGTGTACTCTCC	female
CGAATGTGTCGGCTCA	male
CGAATGTGTTATGCGT	male
CGAATGTTCACAAACC	male
CGAATGTTCTTTAGGG	female
CGACCTTAGCTCAACT	female
CGACCTTAGGGTTCCC	male
CGACCTTCAATCCGAT	male
CGACCTTCACAACGTT	female
CGACCTTCATTACGAC	male
CGACCTTGTTCCTCCA	female
CGACCTTTCCTTGCCA	male
CGACTTCAGCGTTTAC	female
CGACTTCAGGATCGCA	female
CGACTTCCACGAGAGT	male
CGACTTCGTAAGTGGC	female
CGACTTCGTGGTCTCG	female
CGACTTCTCAGAAATG	male
CGACTTCTCAGCTCTC	male
CGAGAAGAGTCGCCGT	female
CGAGAAGAGTGAAGAG	male
CGAGAAGCACTGAAGG	male
CGAGAAGGTACTCTCC	female
CGAGAAGGTCACCCAG	female
CGAGAAGGTGTTCGAT	female
CGAGAAGTCAACCATG	male
CGAGAAGTCGTCTGCT	male
CGAGAAGTCTGCAAGT	female
CGAGCACAGACGACGT	female
CGAGCACAGACTAGGC	female
CGAGCACAGTCCGTAT	female
CGAGCACAGTGGCACA	male
CGAGCACCAAACGCGA	male
CGAGCACCACTTAAGC	female
CGAGCACCATAACCTG	male
CGAGCACGTCAGAATA	female
CGAGCACGTCTCCACT	male
CGAGCACGTGCGAAAC	male
CGAGCACTCACAGTAC	male
CGAGCACTCCGCAGTG	female
CGAGCACTCGACAGCC	male
CGAGCACTCGACCAGC	female
CGAGCACTCGCACTCT	female
CGAGCCACAATTGCTG	male
CGAGCCACAGGATCGA	male
CGAGCCACAGGTCGTC	male
CGAGCCACATGCAACT	male
CGAGCCAGTAAGAGAG	male
CGAGCCAGTTGATTCG	female
CGAGCCATCCGAGCCA	female
CGATCGGAGGATGTAT	female
CGATCGGAGTAGCCGA	female
CGATCGGCATTTGCTT	female
CGATCGGGTACCGTTA	male
CGATCGGGTATCAGTC	female
CGATCGGGTCCAGTAT	female
CGATCGGGTGTATGGG	male
CGATCGGTCCGGCACA	female
CGATCGGTCTATCCTA	male
CGATGGCAGGCGCTCT	female
CGATGGCCAGGACGTA	female
CGATGGCCATGTAGTC	male
CGATGGCGTGACCAAG	female
CGATGGCTCAAGCCTA	female
CGATGGCTCATGTCTT	female
CGATGGCTCTACTATC	female
CGATGTAAGAAGGGTA	male
CGATGTAAGCCACCTG	female
CGATGTAAGCTAACTC	male
CGATGTAAGCTAGTTC	female
CGATGTACAAAGCAAT	male
CGATGTACAACTGCGC	male
CGATGTACAAGGTTTC	male
CGATGTACACTATCTT	male
CGATGTACAGACGCCT	female
CGATGTACAGCCTGTG	male
CGATGTACAGTGGAGT	female
CGATGTACATATGAGA	male
CGATGTAGTACTCAAC	female
CGATGTAGTCAACTGT	male
CGATGTAGTGCGGTAA	male
CGATGTAGTTCGTGAT	male
CGATGTATCACAGTAC	female
CGATGTATCTATCGCC	female
CGATTGAAGAAGGACA	female
CGATTGAAGCGCTCCA	female
CGATTGAAGGGTTCCC	male
CGATTGACAAGGTGTG	male
CGATTGACAGCCTTTC	male
CGATTGACATGACATC	female
CGATTGAGTACCGCTG	female
CGATTGAGTATTCGTG	female
CGATTGATCAGCAACT	female
CGATTGATCCAGAAGG	male
CGCCAAGAGACTAGGC	male
CGCCAAGAGCTGAAAT	female
CGCCAAGAGTGGTAGC	female
CGCCAAGCAGTCCTTC	male
CGCCAAGCAGTGGAGT	male
CGCCAAGCATCCAACA	female
CGCCAAGCATCGGGTC	male
CGCCAAGGTGATAAGT	female
CGCCAAGGTGCTAGCC	female
CGCCAAGGTGGTACAG	male
CGCCAAGTCACCAGGC	male
CGCCAAGTCTGGTATG	female
CGCGGTAAGAAGAAGC	female
CGCGGTAAGACACGAC	female
CGCGGTAAGACTGGGT	female
CGCGGTAAGTCTCCTC	male
CGCGGTACAAAGCAAT	female
CGCGGTACATCTCGCT	male
CGCGGTAGTCATATGC	male
CGCGGTATCAAACAAG	female
CGCGGTATCAAGGCTT	female
CGCGGTATCACATAGC	male
CGCGGTATCAGGCCCA	female
CGCGTTTAGCTTATCG	male
CGCGTTTAGTTTAGGA	male
CGCGTTTCAAACGTGG	male
CGCGTTTCAGATCGGA	female
CGCGTTTCAGGAATGC	male
CGCGTTTGTACCGTAT	female
CGCGTTTGTAGCTTGT	male
CGCGTTTGTATGAAAC	male
CGCGTTTGTGGCAAAC	male
CGCGTTTGTTCGGCAC	male
CGCGTTTTCAAACGGG	male
CGCTATCAGCACGCCT	female
CGCTATCAGCTAAACA	female
CGCTATCAGGTGCTAG	female
CGCTATCAGTTAGCGG	female
CGCTATCCAAGCCATT	female
CGCTATCCAAGCTGGA	male
CGCTATCTCAGGTTCA	male
CGCTATCTCAGTTTGG	female
CGCTATCTCCTTGGTC	male
CGCTGGAAGAAACCAT	female
CGCTGGAAGTCGAGTG	female
CGCTGGACAGGACCCT	female
CGCTGGACATAACCTG	male
CGCTGGACATAGACTC	male
CGCTGGAGTAACGTTC	male
CGCTGGATCAGAGGTG	female
CGCTGGATCCAACCAA	male
CGCTGGATCTAGAGTC	female
CGCTTCAAGATGTCGG	male
CGCTTCAAGCAATCTC	male
CGCTTCAAGCACGCCT	female
CGCTTCAAGCCTTGAT	female
CGCTTCACAAGGTTTC	male
CGCTTCACAGTCCTTC	male
CGCTTCACATGCAATC	female
CGCTTCAGTAAGAGGA	male
CGCTTCAGTACGACCC	male
CGCTTCAGTATGAAAC	female
CGCTTCAGTCAAAGAT	male
CGCTTCAGTCACACGC	male
CGCTTCAGTTCAGTAC	female
CGCTTCATCAGGCGAA	male
CGCTTCATCGCATGAT	female
CGCTTCATCTCGCTTG	male
CGCTTCATCTTTACGT	male
CGGACACAGAACAATC	female
CGGACACCAAGCTGAG	male
CGGACACCACAGTCGC	female
CGGACACCACGCGAAA	female
CGGACACCAGATGAGC	female
CGGACACCATACTACG	female
CGGACACGTGATGTGG	female
CGGACACTCTGTTGAG	male
CGGACGTAGAAGGCCT	female
CGGACGTAGTAAGTAC	female
CGGACGTAGTGACATA	female
CGGACGTAGTTACGGG	female
CGGACGTCAATGGAAT	female
CGGACGTCATGGTTGT	male
CGGACGTGTCCCTACT	female
CGGACGTGTGACGGTA	male
CGGACGTTCAACACAC	male
CGGACGTTCAAGGTAA	female
CGGACGTTCGCTTGTC	female
CGGACGTTCTGCCAGG	male
CGGACGTTCTGGAGCC	female
CGGACTGAGGACATTA	female
CGGACTGAGTCTCAAC	female
CGGACTGAGTGGAGAA	female
CGGACTGCAAGAAGAG	male
CGGACTGCAGGTGCCT	male
CGGACTGCATCACGAT	male
CGGACTGGTCCGAACC	male
CGGACTGGTCGACTAT	male
CGGACTGGTCTACCTC	male
CGGACTGGTGCGATAG	female
CGGACTGTCGCAAGCC	female
CGGAGCTAGAAGATTC	male
CGGAGCTAGAGCTGCA	female
CGGAGCTAGGTGGGTT	male
CGGAGCTCAGGTGGAT	male
CGGAGCTGTACCGTAT	male
CGGAGCTTCACAGTAC	male
CGGAGCTTCAGCTCTC	female
CGGAGCTTCCTGCCAT	female
CGGAGCTTCCTGCTTG	male
CGGAGCTTCGTTTGCC	female
CGGAGCTTCTCCAACC	female
CGGAGTCCACGTTGGC	male
CGGAGTCCACTTAACG	male
CGGAGTCGTAATCACC	female
CGGAGTCGTATCAGTC	female
CGGAGTCGTCAGCTAT	female
CGGAGTCGTCGAACAG	female
CGGAGTCGTCGAGATG	female
CGGAGTCTCATAGCAC	female
CGGCTAGAGAGTGAGA	female
CGGCTAGAGCCGCCTA	female
CGGCTAGAGCGATTCT	female
CGGCTAGAGCTGTCTA	female
CGGCTAGAGTGTACCT	female
CGGCTAGCACATTTCT	female
CGGCTAGCAGGGTACA	male
CGGCTAGCATGAAGTA	female
CGGCTAGGTCTCATCC	female
CGGCTAGTCAGCATGT	male
CGGCTAGTCCCTAATT	female
CGGGTCAAGCCCAATT	female
CGGGTCAAGCTACCGC	female
CGGGTCAAGGCTAGCA	male
CGGGTCAAGGGTCGAT	male
CGGGTCAAGTATCTCG	male
CGGGTCAAGTCCGTAT	female
CGGGTCATCGGTCTAA	female
CGGTTAAAGCTCAACT	female
CGGTTAACAGGGTTAG	male
CGGTTAACAGTATCTG	male
CGGTTAAGTTAGTGGG	female
CGGTTAATCACCTTAT	female
CGGTTAATCATATCGG	female
CGGTTAATCCGTAGTA	male
CGGTTAATCGCGCCAA	female
CGGTTAATCTGCTTGC	male
CGTAGCGAGAGATGAG	male
CGTAGCGAGATATACG	female
CGTAGCGCAGGTCTCG	male
CGTAGCGCATCACCCT	male
CGTAGCGCATGCAATC	female
CGTAGCGGTTCCCTTG	male
CGTAGGCAGCACACAG	male
CGTAGGCCAATCGGTT	male
CGTAGGCCAGGCTCAC	female
CGTAGGCCATGCCCGA	female
CGTAGGCGTAGCAAAT	male
CGTAGGCTCAACACGT	male
CGTAGGCTCGTTGCCT	female
CGTAGGCTCTTTACAC	female
CGTCACTAGAGACTAT	male
CGTCACTAGATGGCGT	female
CGTCACTCACTACAGT	male
CGTCACTGTAGGGACT	female
CGTCACTGTATATGGA	female
CGTCACTGTGACTCAT	female
CGTCACTTCATGTAGC	male
CGTCACTTCCGAATGT	female
CGTCACTTCTCGATGA	female
CGTCACTTCTTATCTG	female
CGTCAGGAGACACTAA	female
CGTCAGGAGAGGTTGC	female
CGTCAGGAGGACAGAA	female
CGTCAGGCAGTTCATG	female
CGTCAGGCATCAGTCA	female
CGTCAGGCATGGTCTA	male
CGTCAGGGTGGTAACG	male
CGTCCATAGAATGTGT	male
CGTCCATAGAGACTTA	female
CGTCCATAGATGTAAC	male
CGTCCATAGCAGGTCA	male
CGTCCATAGGAGTTTA	female
CGTCCATAGGCTACGA	female
CGTCCATAGGTGCTTT	female
CGTCCATCAGCATACT	male
CGTCCATCATAGGATA	female
CGTCCATGTAAAGTCA	female
CGTCCATGTCACAAGG	female
CGTCCATGTCACTTCC	male
CGTCCATGTCGTGGCT	male
CGTCCATGTGAACCTT	female
CGTCCATTCATAACCG	female
CGTCCATTCCACTCCA	male
CGTCCATTCCCGGATG	male
CGTCCATTCGAATGCT	female
CGTCCATTCTCTAAGG	male
CGTCTACAGAGAACAG	male
CGTCTACAGTGACATA	female
CGTCTACCAATTCCTT	male
CGTCTACCAGACGCAA	female
CGTCTACCAGTAAGCG	female
CGTCTACGTCCGAATT	female
CGTCTACGTGAGTGAC	female
CGTCTACGTTTGCATG	female
CGTCTACTCATAGCAC	female
CGTCTACTCCCATTTA	female
CGTCTACTCTGTCTCG	male
CGTGAGCAGCTATGCT	male
CGTGAGCCACCAGCAC	male
CGTGAGCCATCACAAC	male
CGTGAGCGTAAATGAC	female
CGTGAGCGTGATGATA	male
CGTGAGCGTTACAGAA	male
CGTGTAAAGACTAGAT	female
CGTGTAACAAGCTGAG	female
CGTGTAACACCTCGTT	female
CGTGTAAGTAGCTCCG	male
CGTGTAAGTCGCGGTT	male
CGTGTAAGTTAAGACA	female
CGTGTAATCGTGGTCG	male
CGTGTAATCTGTCTAT	male
CGTGTCTAGCTGGAAC	female
CGTGTCTAGGGTCGAT	male
CGTGTCTCACAGGAGT	female
CGTGTCTGTAAGGGAA	male
CGTGTCTGTACCATCA	female
CGTGTCTGTCTTCTCG	male
CGTGTCTGTGTGCCTG	female
CGTGTCTGTGTGGTTT	male
CGTGTCTTCACTCTTA	female
CGTGTCTTCCAAATGC	male
CGTGTCTTCCGAATGT	male
CGTGTCTTCCGTAGGC	male
CGTTAGAAGCAGATCG	male
CGTTAGACAGATTGCT	female
CGTTAGACAGCGTTCG	male
CGTTAGAGTGTTGGGA	female
CGTTAGATCATTTGGG	female
CGTTAGATCCAAATGC	male
CGTTAGATCGTTTAGG	female
CGTTAGATCTACGAGT	male
CGTTAGATCTCCAACC	female
CGTTCTGAGAGGGCTT	male
CGTTCTGAGTAACCCT	male
CGTTCTGCACTTCGAA	female
CGTTCTGCAGCATACT	male
CGTTCTGCAGGTGGAT	male
CGTTCTGCAGTAAGCG	male
CGTTCTGGTCGCTTTC	female
CGTTCTGTCAATCACG	male
CGTTCTGTCACGCGGT	female
CGTTCTGTCGAACGGA	female
CGTTGGGAGCCACGTC	female
CGTTGGGAGTAGATGT	female
CGTTGGGAGTCTTGCA	female
CGTTGGGAGTGTGAAT	male
CGTTGGGAGTTGTCGT	male
CGTTGGGCATACCATG	female
CGTTGGGGTCTGATTG	female
CGTTGGGGTGCCTTGG	female
CGTTGGGGTGTATGGG	female
CGTTGGGTCTGCCCTA	female
CTAACTTAGACGCAAC	male
CTAACTTAGTGCGTGA	male
CTAACTTCACAGCGTC	male
CTAACTTCACTGCCAG	male
CTAACTTGTACCGCTG	female
CTAACTTTCATGTAGC	male
CTAACTTTCCAACCAA	male
CTAACTTTCTTATCTG	female
CTAAGACAGAAGGTTT	female
CTAAGACAGAGGTTGC	male
CTAAGACAGAGTGAGA	male
CTAAGACAGCTATGCT	male
CTAAGACAGGCAATTA	male
CTAAGACAGGTAAACT	male
CTAAGACCACATAACC	male
CTAAGACCACTGTCGG	female
CTAAGACCATCGACGC	female
CTAAGACTCCGTCAAA	female
CTAAGACTCGGAGCAA	male
CTAAGACTCGTTTGCC	male
CTAAGACTCTGCCCTA	male
CTAATGGAGCGTTTAC	female
CTAATGGAGTTAGGTA	female
CTAATGGCATCGGTTA	female
CTAATGGGTCTAAACC	male
CTAATGGGTCTCGTTC	male
CTAATGGGTTCAGACT	female
CTAATGGTCCAGTATG	male
CTAATGGTCCGATATG	male
CTAATGGTCCGCTGTT	female
CTACACCAGATATACG	male
CTACACCAGGACATTA	male
CTACACCAGTGTACTC	female
CTACACCCAAACAACA	female
CTACACCGTTAAAGTG	male
CTACACCGTTACGTCA	male
CTACACCTCACTATTC	female
CTACATTAGGCCCGTT	female
CTACATTAGGCCCTCA	male
CTACATTAGGTAGCTG	male
CTACATTAGTTTAGGA	female
CTACATTCACACATGT	male
CTACATTCAGCGTAAG	female
CTACATTCAGGGATTG	male
CTACATTGTGAGGGTT	female
CTACATTGTTATCACG	male
CTACATTTCAACCATG	male
CTACATTTCTGGCGAC	male
CTACCCAAGATCCTGT	female
CTACCCAAGCCACTAT	female
CTACCCACAATGGAGC	male
CTACCCACAATGGTCT	female
CTACCCACAGCTTAAC	male
CTACCCACATAGAAAC	female
CTACCCAGTCCGCTGA	male
CTACCCAGTCTGATCA	female
CTACCCAGTGGAAAGA	female
CTACCCAGTGGCTCCA	female
CTACCCATCCAAGCCG	male
CTACCCATCCACGACG	female
CTACCCATCTTCGAGA	male
CTACGTCAGCTCCTTC	female
CTACGTCAGTCGTACT	male
CTACGTCCAGTATAAG	female
CTACGTCGTAAGAGGA	male
CTACGTCGTAGCACGA	female
CTACGTCTCAATAAGG	male
CTAGAGTAGAAACCGC	male
CTAGAGTCATATACGC	female
CTAGAGTGTTCACGGC	female
CTAGCCTAGAGCTATA	female
CTAGCCTAGCCAGAAC	male
CTAGCCTAGGATATAC	female
CTAGCCTAGGGTTTCT	female
CTAGCCTCAGGACGTA	male
CTAGCCTCATCACGTA	female
CTAGCCTGTACCATCA	female
CTAGCCTGTCACTGGC	female
CTAGCCTTCAGCACAT	female
CTAGCCTTCTACCAGA	male
CTAGCCTTCTGTCTAT	male
CTAGTGAAGATATGGT	male
CTAGTGACACGGTAGA	male
CTAGTGAGTAAGTGGC	male
CTAGTGAGTGATAAAC	female
CTAGTGAGTTATCCGA	male
CTAGTGATCGACGGAA	female
CTCACACAGATCGATA	male
CTCACACAGGACTGGT	female
CTCACACCACAGACTT	male
CTCACACCAGGTTTCA	female
CTCACACGTAGCGATG	male
CTCACACGTCATCCCT	male
CTCACACTCCTAGGGC	female
CTCACACTCGGCATCG	female
CTCACACTCTCCAGGG	male
CTCAGAAAGAAACCTA	female
CTCAGAAAGTTACCCA	male
CTCAGAACAAGCTGTT	male
CTCAGAACAATGAATG	male
CTCATTAAGAAGGGTA	male
CTCATTAAGAGTGAGA	male
CTCATTAAGTTTGCGT	female
CTCATTACAATGGACG	female
CTCATTACACCGTTGG	male
CTCATTAGTCTTGCGG	male
CTCCTAGAGAAACGCC	female
CTCCTAGAGGTGCACA	male
CTCCTAGAGTAGGTGC	male
CTCCTAGCAAACGTGG	female
CTCCTAGCAAAGGAAG	female
CTCCTAGCACCCAGTG	female
CTCCTAGCAGACAAGC	female
CTCCTAGCAGATGGCA	female
CTCCTAGCAGCGATCC	male
CTCCTAGCAGTCCTTC	male
CTCCTAGCATGATCCA	female
CTCCTAGCATGTTCCC	male
CTCCTAGGTTGTTTGG	male
CTCCTAGTCCTTAATC	female
CTCCTAGTCGATAGAA	female
CTCGAAAAGATTACCC	female
CTCGAAAAGGGATACC	male
CTCGAAAAGTACGACG	male
CTCGAAAAGTACGTTC	male
CTCGAAAAGTTCCACA	male
CTCGAAACACCCTATC	female
CTCGAAACATGTCGAT	female
CTCGAAAGTAGCGCAA	male
CTCGAAAGTTCAGACT	female
CTCGAAAGTTGGTAAA	male
CTCGAAATCAGTTCGA	male
CTCGAAATCCGCGTTT	male
CTCGAGGAGGGCATGT	male
CTCGAGGCACCGAAAG	male
CTCGAGGCACCTCGTT	female
CTCGAGGCACTCTGTC	male
CTCGAGGCAGGATCGA	male
CTCGAGGCATAGAAAC	female
CTCGAGGGTCTTGATG	male
CTCGAGGGTTGGTTTG	male
CTCGAGGGTTTGTTGG	male
CTCGAGGTCAACGAAA	male
CTCGAGGTCACGAAGG	male
CTCGGAGAGCTAGTGG	female
CTCGGAGAGGTGTTAA	male
CTCGGAGAGTGTGAAT	male
CTCGGAGCAACGCACC	female
CTCGGAGCATGACGGA	male
CTCGGAGTCAGAGCTT	female
CTCGGAGTCAGTCAGT	female
CTCGGAGTCCTCGCAT	female
CTCGGAGTCTGCTGCT	male
CTCGGGAAGGAGTCTG	female
CTCGGGACAAGACACG	female
CTCGGGACATGTTCCC	male
CTCGGGAGTGTCGCTG	female
CTCGGGAGTTATTCTC	male
CTCGGGAGTTCCACAA	female
CTCGTACAGCCCTAAT	male
CTCGTACGTCAAAGCG	male
CTCGTACGTCGGGTCT	male
CTCGTACGTGCCTGGT	female
CTCGTACGTTTGCATG	female
CTCGTACTCAGAAATG	male
CTCGTACTCTCTTATG	male
CTCGTACTCTGCGACG	male
CTCGTACTCTGTCAAG	male
CTCGTCAAGTGCCATT	female
CTCGTCACAAATACAG	female
CTCGTCACACAGGTTT	male
CTCGTCACACGTAAGG	female
CTCGTCAGTAAGCACG	female
CTCGTCAGTACCCAAT	female
CTCGTCAGTGTGGCTC	female
CTCGTCATCAGCTCTC	female
CTCGTCATCCCAACGG	male
CTCGTCATCGTGGACC	male
CTCGTCATCGTTGACA	male
CTCGTCATCTGCCCTA	male
CTCTAATAGTGGAGAA	female
CTCTAATCAAAGGAAG	female
CTCTAATGTGAGTGAC	male
CTCTAATGTGCAGTAG	female
CTCTAATTCAATCACG	female
CTCTAATTCCAATGGT	male
CTCTAATTCCAGTATG	female
CTCTAATTCCTATTCA	female
CTCTAATTCCTTCAAT	male
CTCTAATTCGGATGTT	female
CTCTACGAGCTAGTTC	male
CTCTACGAGTAACCCT	female
CTCTACGCAATCGAAA	female
CTCTACGCACATTCGA	female
CTCTACGCAGGGCATA	female
CTCTACGCAGGGTATG	female
CTCTACGTCATCGATG	male
CTCTGGTAGAATTCCC	female
CTCTGGTAGCAATCTC	male
CTCTGGTAGGCTATCT	male
CTCTGGTAGGGCTTGA	female
CTCTGGTCAATGGATA	female
CTCTGGTCACAACGTT	male
CTCTGGTCATCGTCGG	male
CTCTGGTCATGCATGT	male
CTCTGGTGTCAACATC	female
CTCTGGTGTCCCGACA	male
CTCTGGTGTTACAGAA	female
CTCTGGTTCAGTGCAT	female
CTCTGGTTCCGCAAGC	female
CTCTGGTTCGGAGGTA	female
CTGAAACCATTTGCCC	female
CTGAAACGTAATCGTC	male
CTGAAACGTGAGCGAT	male
CTGAAACTCGACAGCC	female
CTGAAACTCGTTGACA	male
CTGAAACTCTCTTATG	female
CTGAAACTCTTGTATC	female
CTGAAGTAGACCTTTG	male
CTGAAGTAGCTAAGAT	male
CTGAAGTAGTGAACAT	female
CTGAAGTAGTGGAGAA	male
CTGAAGTAGTGTGGCA	female
CTGAAGTCAATGCCAT	female
CTGAAGTCAGTAAGCG	male
CTGAAGTCATCGACGC	female
CTGAAGTGTCTAAAGA	female
CTGAAGTGTGGCGAAT	male
CTGAAGTGTTCAGACT	female
CTGAAGTTCTCGGACG	female
CTGATAGAGAAACCAT	female
CTGATAGAGAAACGCC	female
CTGATAGAGACGACGT	female
CTGATAGAGCGTCAAG	female
CTGATAGAGTGTGAAT	female
CTGATAGAGTTGTAGA	female
CTGATAGCAATGGACG	female
CTGATAGCACCAGATT	female
CTGATAGCACGGTGTC	female
CTGATAGGTAGAAAGG	male
CTGATAGGTCAGGACA	female
CTGATAGGTTCACCTC	female
CTGATAGTCAAACCAC	male
CTGATAGTCAACACCA	male
CTGATAGTCCAACCAA	female
CTGATAGTCCCAGGTG	male
CTGATCCAGACACGAC	male
CTGATCCAGTACGACG	male
CTGATCCCATGCCTAA	female
CTGATCCCATGCGCAC	female
CTGATCCGTAGCGTCC	female
CTGATCCGTATTCTCT	male
CTGATCCGTCCGTTAA	male
CTGATCCGTTTAGGAA	female
CTGATCCTCATGCATG	female
CTGATCCTCGTCACGG	female
CTGCCTAAGCAATCTC	female
CTGCCTAAGCTACCTA	female
CTGCCTAAGGCCATAG	male
CTGCCTACACCATGTA	female
CTGCCTACACTACAGT	female
CTGCCTACAGCTCGCA	female
CTGCCTACATGCCCGA	female
CTGCCTACATGTCTCC	female
CTGCCTAGTCGCGGTT	male
CTGCCTAGTCTCTCGT	male
CTGCCTAGTCTGGTCG	female
CTGCCTAGTGGTAACG	female
CTGCCTATCATGTAGC	female
CTGCCTATCGGCGCTA	female
CTGCGGAAGAGTGACC	male
CTGCGGAAGCAGCGTA	male
CTGCGGAAGTCTCGGC	male
CTGCGGACAAACGCGA	female
CTGCGGACATCGGAAG	male
CTGCGGAGTAGAAGGA	male
CTGCGGAGTCGAATCT	female
CTGCGGAGTGAGTGAC	male
CTGCGGAGTGTTGAGG	male
CTGCGGATCAACGGCC	female
CTGCGGATCATCATTC	male
CTGCTGTAGCCACCTG	male
CTGCTGTAGCTGCCCA	male
CTGCTGTAGGCGATAC	female
CTGCTGTCAACCGCCA	male
CTGCTGTCAAGTCTAC	male
CTGCTGTCACCAGGTC	male
CTGCTGTCATGCGCAC	female
CTGCTGTGTACACCGC	male
CTGCTGTGTCAGTGGA	female
CTGCTGTGTCCTCCAT	male
CTGCTGTTCAAAGACA	male
CTGCTGTTCCGTTGTC	male
CTGCTGTTCTCACATT	male
CTGCTGTTCTGAGTGT	male
CTGGTCTAGAGCTATA	male
CTGGTCTAGCTGTCTA	male
CTGGTCTCAGTACACT	male
CTGGTCTCATTCCTCG	female
CTGGTCTCATTGAGCT	male
CTGGTCTGTAACGCGA	male
CTGGTCTGTACAGCAG	male
CTGGTCTGTGTAATGA	male
CTGGTCTTCCAGAAGG	female
CTGTGCTCAAACGTGG	female
CTGTGCTCAACCGCCA	male
CTGTGCTCAAGAGTCG	female
CTGTGCTGTACATCCA	male
CTGTGCTTCCCAACGG	female
CTGTGCTTCTGCGGCA	female
CTGTTTAAGACAATAC	male
CTGTTTAAGAGTAATC	female
CTGTTTAAGCCCAACC	female
CTGTTTACACAAGCCC	female
CTGTTTACATGAACCT	female
CTGTTTAGTAAGTGGC	female
CTGTTTAGTACAGTTC	male
CTGTTTAGTCTCGTTC	female
CTGTTTAGTGATGATA	male
CTGTTTATCACAGTAC	female
CTGTTTATCACCCTCA	female
CTGTTTATCACGACTA	male
CTGTTTATCCTATTCA	male
CTGTTTATCGGCGCTA	female
CTGTTTATCTGTGCAA	male
CTTAACTAGAAAGTGG	male
CTTAACTAGAACTGTA	male
CTTAACTAGCTACCTA	male
CTTAACTAGGGCACTA	female
CTTAACTCAAGTTCTG	male
CTTAACTCATGGGAAC	male
CTTAACTTCCGGGTGT	male
CTTAACTTCGAATGCT	male
CTTACCGAGGACTGGT	female
CTTACCGAGGGTTTCT	male
CTTACCGAGTCAAGCG	female
CTTACCGAGTGGAGAA	male
CTTACCGTCCGTTGCT	female
CTTACCGTCGAATCCA	female
CTTACCGTCGCGGATC	female
CTTAGGAAGACACGAC	female
CTTAGGAAGCATGGCA	female
CTTAGGACAGTTTACG	female
CTTAGGACATTCCTGC	male
CTTAGGAGTCTACCTC	female
CTTAGGAGTCTCTCTG	male
CTTAGGATCACCTTAT	female
CTTAGGATCCATGCTC	male
CTTAGGATCCGCAGTG	male
CTTCTCTAGCCCGAAA	female
CTTCTCTAGCGATAGC	female
CTTCTCTAGCTAACAA	male
CTTCTCTAGGTAGCCA	male
CTTCTCTAGTTCCACA	female
CTTCTCTCACCGTTGG	female
CTTCTCTCACGAAACG	female
CTTCTCTGTCCGAACC	male
CTTCTCTGTCTAGCCG	female
CTTCTCTTCAGAGGTG	male
CTTCTCTTCGACAGCC	male
CTTCTCTTCGTAGATC	male
CTTCTCTTCTCTGTCG	male
CTTGGCTAGTAGTGCG	female
CTTGGCTAGTGCAAGC	female
CTTGGCTCAGCTGTTA	male
CTTGGCTGTACAGCAG	female
CTTGGCTGTACCGTAT	female
CTTGGCTGTCATCGGC	male
CTTGGCTGTCTCGTTC	female
CTTGGCTGTGCGGTAA	female
CTTGGCTGTGCTCTTC	female
CTTGGCTGTGGGTATG	male
CTTGGCTGTTGTTTGG	female
CTTTGCGAGAGTAAGG	male
CTTTGCGAGCTCCTCT	female
CTTTGCGAGGGAACGG	female
CTTTGCGCACCACCAG	male
CTTTGCGCATAAGACA	male
CTTTGCGCATCATCCC	female
CTTTGCGGTCCTGCTT	female
CTTTGCGGTCTCTCGT	female
CTTTGCGGTCTCTCTG	female
CTTTGCGTCATCGGAT	male
GAAACTCAGATATGGT	male
GAAACTCAGCCCAACC	male
GAAACTCAGGACGAAA	male
GAAACTCCACCGTTGG	male
GAAACTCCACCTATCC	male
GAAACTCCACGGCTAC	male
GAAACTCCAGTTTACG	male
GAAACTCGTCATACTG	male
GAAACTCGTCCAGTTA	male
GAAACTCGTCTAGGTT	female
GAAACTCGTGTTCGAT	female
GAAACTCTCAGTCCCT	female
GAAACTCTCCTCCTAG	female
GAAACTCTCGCGATCG	male
GAAATGAAGCCAGTAG	male
GAAATGAAGGCTCTTA	male
GAAATGAAGTACATGA	female
GAAATGAAGTGTACTC	male
GAAATGACAAAGGCGT	male
GAAATGAGTAGCCTAT	male
GAAATGAGTCATGCAT	male
GAAATGAGTCCGAGTC	female
GAAATGAGTCGGGTCT	male
GAAATGATCATTATCC	male
GAAATGATCCTTTCGG	female
GAAATGATCTGCGGCA	female
GAACATCAGGCTATCT	male
GAACATCAGTGTTTGC	female
GAACATCCACCTGGTG	male
GAACATCCATACTCTT	female
GAACATCCATTCTTAC	male
GAACATCGTCCCTTGT	male
GAACATCGTCGAGATG	female
GAACATCGTTCGTCTC	male
GAACATCGTTGATTGC	male
GAACATCTCACGATGT	male
GAACATCTCCCTCAGT	female
GAACATCTCTCCAGGG	female
GAACCTAAGGGTTCCC	female
GAACCTAAGGGTTTCT	male
GAACCTAAGTACTTGC	male
GAACCTACAACTGCGC	male
GAACCTACAAGTAATG	female
GAACCTAGTATTAGCC	male
GAACCTAGTCCTCCAT	male
GAACCTATCACCTTAT	female
GAACCTATCATCGGAT	female
GAACCTATCCATGAAC	male
GAACGGAAGTACGTAA	female
GAACGGAAGTGCTGCC	female
GAACGGACAAACTGTC	female
GAACGGACAAGCTGGA	male
GAACGGACAATCGAAA	male
GAACGGACATAACCTG	male
GAACGGAGTAGAGGAA	male
GAACGGAGTCTCTTAT	male
GAACGGAGTCTGATTG	female
GAACGGAGTCTGGTCG	female
GAACGGAGTGCGATAG	male
GAACGGAGTTGGAGGT	female
GAACGGATCACCATAG	female
GAACGGATCAGTACGT	male
GAAGCAGAGACAAAGG	male
GAAGCAGAGGACACCA	female
GAAGCAGAGTGGCACA	male
GAAGCAGCAAGACGTG	female
GAAGCAGCATCGTCGG	male
GAAGCAGCATGGTTGT	male
GAAGCAGGTAGAAAGG	male
GAAGCAGGTCACACGC	female
GAAGCAGGTCACCTAA	female
GAAGCAGGTGGCGAAT	male
GAAGCAGGTGGTAACG	male
GAAGCAGGTGTGCGTC	female
GAAGCAGTCAGCGACC	male
GAAGCAGTCTGTTTGT	male
GAATAAGCACATCTTT	male
GAATAAGCATTATCTC	female
GAATAAGTCCTCCTAG	male
GAATAAGTCCTTGACC	male
GAATAAGTCGGTCTAA	female
GAATAAGTCTACGAGT	female
GAATAAGTCTTGTACT	male
GAATGAAAGAGCTGGT	female
GAATGAAAGTGTTAGA	female
GAATGAACAATGTAAG	male
GAATGAACACATGACT	male
GAATGAACATGGAATA	male
GAATGAAGTCCTGCTT	male
GAATGAAGTCGCTTCT	female
GAATGAAGTCTCCACT	male
GAATGAATCAGGTTCA	male
GAATGAATCTAGCACA	female
GACACGCAGGCTCTTA	female
GACACGCAGGGATACC	female
GACACGCAGGTGCAAC	female
GACACGCCAAAGCAAT	female
GACACGCCAAGTTAAG	female
GACACGCCATATGAGA	male
GACACGCCATGACGGA	male
GACACGCGTAAACGCG	male
GACACGCGTTACCGAT	male
GACACGCGTTGTGGAG	female
GACACGCTCAACGCTA	male
GACAGAGAGCCAGAAC	female
GACAGAGAGCTGTTCA	male
GACAGAGCAAGCCGTC	male
GACAGAGCAGGACCCT	male
GACAGAGCATGGTCAT	female
GACAGAGGTAGCCTAT	male
GACAGAGTCATTATCC	male
GACAGAGTCCCTCAGT	male
GACAGAGTCCTGCAGG	male
GACCAATAGACACTAA	male
GACCAATAGTAGATGT	female
GACCAATAGTGGAGAA	female
GACCAATCAACTGCTA	female
GACCAATCAGATGAGC	female
GACCAATGTCAAGCGA	male
GACCAATTCCCATTAT	male
GACCAATTCGGCTACG	male
GACCAATTCTCGCATC	female
GACCTGGAGCCACGCT	female
GACCTGGAGGGTGTTG	male
GACCTGGAGTCCATAC	female
GACCTGGCAGTATCTG	female
GACCTGGTCCGTTGTC	female
GACCTGGTCCTATTCA	male
GACCTGGTCTACTATC	female
GACGCGTAGAATTCCC	female
GACGCGTAGCGATTCT	female
GACGCGTCACCATCCT	male
GACGCGTCACCATGTA	male
GACGCGTGTCAAAGCG	male
GACGCGTTCAAGCCTA	male
GACGCGTTCAGATAAG	female
GACGCGTTCAGCTCTC	female
GACGCGTTCATGTAGC	female
GACGCGTTCCCGACTT	male
GACGCGTTCGATGAGG	female
GACGCGTTCGTAGATC	female
GACGGCTAGCAAATCA	female
GACGGCTAGGCTCTTA	female
GACGGCTCAGCTCGCA	female
GACGGCTCAGTAAGAT	female
GACGGCTCATCTGGTA	female
GACGGCTGTAAGGGCT	female
GACGGCTGTCAGCTAT	male
GACGGCTGTCCGAACC	female
GACGGCTGTCTTCTCG	female
GACGGCTTCAACGAAA	male
GACGGCTTCGCGTTTC	female
GACGTGCAGAGGTTGC	female
GACGTGCCAGGGTACA	female
GACGTGCGTGAACCTT	male
GACGTGCTCAAGCCTA	female
GACGTGCTCTACTTAC	male
GACGTGCTCTTGTTTG	female
GACGTTAAGAGACTAT	male
GACGTTAAGGATGCGT	male
GACGTTAAGGGTGTTG	male
GACGTTACAAACAACA	male
GACGTTACACTCTGTC	female
GACGTTACATCGGACC	male
GACGTTACATGCGCAC	female
GACGTTATCGGTTCGG	male
GACTAACAGATCCTGT	male
GACTAACAGGCAAAGA	male
GACTAACAGGCTCTTA	female
GACTAACCACATCCGG	male
GACTAACCACTTCTGC	female
GACTAACCATTGGCGC	female
GACTAACGTAAACGCG	female
GACTACAAGAATGTGT	male
GACTACAAGCTCCTTC	male
GACTACAAGTTTAGGA	male
GACTACACAAAGGAAG	male
GACTACACACAGATTC	male
GACTACACACATGTGT	female
GACTACAGTCAAAGAT	male
GACTACAGTGATAAAC	male
GACTACAGTGGCGAAT	male
GACTACAGTGGTCTCG	female
GACTACAGTTGGTAAA	male
GACTACATCCTGTAGA	male
GACTGCGAGAATGTTG	male
GACTGCGAGCGATGAC	male
GACTGCGAGTCAATAG	male
GACTGCGCAAGTCTGT	female
GACTGCGGTAGGCTGA	male
GACTGCGGTGGTCTCG	male
GACTGCGGTTGTTTGG	female
GACTGCGTCCGCATCT	male
GACTGCGTCGGTTCGG	male
GAGCAGAAGAGTAAGG	female
GAGCAGAAGATCCTGT	female
GAGCAGAAGCCACCTG	female
GAGCAGAAGTAGCCGA	female
GAGCAGACAATGACCT	male
GAGCAGACATGGTCTA	male
GAGCAGAGTCAACATC	female
GAGCAGAGTCACTGGC	female
GAGCAGAGTGAGCGAT	male
GAGCAGAGTTCAGGCC	female
GAGCAGATCAGTTTGG	female
GAGCAGATCCGGCACA	male
GAGCAGATCGCCCTTA	female
GAGCAGATCGCGCCAA	female
GAGCAGATCGGGAGTA	female
GAGCAGATCGTACCGG	male
GAGCAGATCTTCGGTC	male
GAGGTGAAGACCTTTG	male
GAGGTGAAGCGCTTAT	female
GAGGTGAAGCTGCCCA	female
GAGGTGAAGGCTAGGT	female
GAGGTGAGTACAGTGG	male
GAGGTGAGTAGCCTCG	male
GAGGTGAGTATGGTTC	male
GAGGTGAGTTGTGGAG	female
GAGTCCGAGAGGTACC	male
GAGTCCGAGGATGTAT	male
GAGTCCGAGTTGCAGG	male
GAGTCCGCACAAGACG	male
GAGTCCGCACCAGGTC	female
GAGTCCGCATATGAGA	female
GAGTCCGGTCGAGATG	male
GAGTCCGGTGAAATCA	male
GAGTCCGGTGTTTGTG	male
GAGTCCGTCATGTCCC	male
GAGTCCGTCCGGCACA	male
GAGTCCGTCTCAAACG	male
GAGTCCGTCTTTCCTC	female
GATCAGTAGAGTTGGC	female
GATCAGTAGCCTCGTG	male
GATCAGTCAATAGCAA	male
GATCAGTCAGACAGGT	male
GATCAGTGTATAATGG	female
GATCAGTGTCCTGCTT	female
GATCAGTGTGTGGCTC	female
GATCAGTTCAGCCTAA	male
GATCAGTTCGGCATCG	female
GATCGATAGCTACCTA	male
GATCGATCATGGTCTA	male
GATCGATGTAAGTGTA	female
GATCGATTCAGTCCCT	female
GATCGATTCCGAAGAG	male
GATCGATTCTTCTGGC	male
GATCGCGAGAAGGCCT	male
GATCGCGAGACTAAGT	female
GATCGCGAGAGCTATA	female
GATCGCGAGATCTGAA	female
GATCGCGAGTGTCTCA	male
GATCGCGAGTTCCACA	female
GATCGCGCACTCGACG	female
GATCGCGCAGGGTACA	female
GATCGCGTCACCCTCA	male
GATCGCGTCATCGATG	male
GATCGCGTCCTAGTGA	female
GATCGTAAGTGCTGCC	female
GATCGTACATACGCCG	male
GATCGTAGTACGACCC	male
GATCGTAGTAGGGACT	male
GATCGTAGTGAAGGCT	female
GATCGTAGTGGCCCTA	female
GATCGTAGTTGTGGAG	male
GATCGTATCCATTCTA	male
GATCGTATCGTTACGA	male
GATCTAGAGCAACGGT	female
GATCTAGAGCCCAGCT	female
GATCTAGAGCTCCTCT	male
GATCTAGAGGCTAGGT	male
GATCTAGAGTGAAGTT	female
GATCTAGCACTTCTGC	female
GATCTAGGTATGAATG	male
GATCTAGGTCTCCATC	female
GATCTAGGTCTCGTTC	female
GATCTAGGTGGCGAAT	female
GATCTAGGTTACCAGT	male
GATCTAGTCAAACAAG	male
GATCTAGTCAACCATG	male
GATCTAGTCACAACGT	female
GATCTAGTCACCATAG	female
GATCTAGTCACTCCTG	male
GATGAAAAGAAACCTA	female
GATGAAAAGAGGTACC	male
GATGAAAAGCCGTCGT	male
GATGAAACACGGTGTC	female
GATGAAACATCAGTCA	male
GATGAAAGTAGAAGGA	female
GATGAAATCACAACGT	female
GATGAAATCTCGCATC	male
GATGAGGAGAAGGCCT	female
GATGAGGAGAGTCGGT	male
GATGAGGCAATCCAAC	male
GATGAGGCAGACAAAT	male
GATGAGGCAGACACTT	female
GATGAGGCAGGTCCAC	female
GATGAGGGTCATGCCG	male
GATGAGGTCAGTTAGC	female
GATGAGGTCCAAGTAC	male
GATGCTAAGGGATACC	female
GATGCTAAGTAATCCC	female
GATGCTACACTGTTAG	female
GATGCTACAGCGATCC	male
GATGCTACATGCAATC	female
GATGCTATCCGCGGTA	male
GATGCTATCCGGGTGT	female
GATGCTATCGCCGTGA	male
GATGCTATCTTTAGGG	female
GATTCAGAGAGTAAGG	male
GATTCAGAGGGATACC	female
GATTCAGCACGGTAGA	female
GATTCAGCATCGGAAG	male
GATTCAGGTTTAGCTG	male
GATTCAGTCTTAGCCC	female
GCAAACTAGCTCCTTC	female
GCAAACTCAATGAATG	female
GCAAACTCAATGGAGC	female
GCAAACTCACCGGAAA	female
GCAAACTCATCCCACT	female
GCAAACTGTAGGCTGA	female
GCAAACTGTCACCCAG	female
GCAAACTGTCTCATCC	male
GCAAACTGTGCAACGA	female
GCAAACTTCAAACCAC	female
GCAAACTTCAGAGGTG	female
GCAAACTTCTCAACTT	female
GCAATCAAGCCCAACC	male
GCAATCAAGGGCTCTC	female
GCAATCAAGTGTACCT	male
GCAATCACACAGCGTC	female
GCAATCACAGCGTCCA	female
GCAATCACATTATCTC	female
GCAATCAGTTATCCGA	female
GCAATCATCCGCAGTG	female
GCAATCATCCTTGGTC	female
GCAATCATCTCGAGTA	female
GCAATCATCTGATACG	male
GCACATAAGACTAAGT	female
GCACATAAGGAATTAC	female
GCACATACAAAGTCAA	female
GCACATACAAGCTGAG	male
GCACATACACACGCTG	female
GCACATACATCCGTGG	male
GCACATACATTGGCGC	female
GCACATAGTGTGAATA	female
GCACATAGTTGAGTTC	male
GCACATATCTGTTTGT	female
GCACTCTAGAAACGAG	female
GCACTCTAGACTAGGC	female
GCACTCTAGCTAAGAT	female
GCACTCTCATAACCTG	male
GCACTCTGTAAGTTCC	female
GCACTCTGTCGACTAT	female
GCACTCTGTCTGATCA	female
GCACTCTGTGAAGGCT	male
GCACTCTGTGACGCCT	female
GCACTCTGTGCGAAAC	male
GCACTCTTCATTTGGG	male
GCAGCCAAGCTCCTCT	male
GCAGCCACATCAGTCA	male
GCAGCCACATCTATGG	female
GCAGCCACATGTAAGA	female
GCAGCCAGTCCGTCAG	female
GCAGCCAGTGGCAAAC	male
GCAGCCAGTTACGTCA	male
GCAGCCAGTTGGAGGT	male
GCAGCCATCGTGGACC	female
GCAGCCATCTGATACG	female
GCAGTTACAAAGTGCG	male
GCAGTTACAAGGACAC	male
GCAGTTACAATGGTCT	male
GCAGTTACATTGGGCC	male
GCAGTTAGTATTAGCC	male
GCAGTTAGTCAGAAGC	male
GCAGTTAGTCTCTTAT	female
GCAGTTAGTGAGGGTT	male
GCAGTTAGTTGTACAC	male
GCAGTTAGTTGTTTGG	male
GCAGTTATCCTTTCGG	female
GCATACAAGCCACCTG	male
GCATACAAGGCATGGT	female
GCATACAAGGGATGGG	male
GCATACAAGGTGTGGT	male
GCATACACACCAGATT	female
GCATACACATCCGCGA	male
GCATACACATGCCTTC	female
GCATACAGTACCGAGA	female
GCATACAGTAGCGTAG	female
GCATACATCACCCTCA	male
GCATACATCAGAGACG	male
GCATACATCGGCCGAT	female
GCATACATCGGCGGTT	female
GCATACATCTGCTGCT	male
GCATGATAGATCGGGT	male
GCATGATAGCAGACTG	female
GCATGATAGCGATTCT	male
GCATGATCACAGGCCT	male
GCATGATCAGCTCGAC	female
GCATGATGTCTCCATC	female
GCATGATTCACAGGCC	female
GCATGATTCGCGCCAA	male
GCATGATTCGCTTAGA	female
GCATGATTCTAACTCT	male
GCATGCGGTACTTGAC	female
GCATGCGGTTCCACAA	female
GCATGCGGTTCCATGA	female
GCATGCGGTTGGTTTG	male
GCATGTACATCGGTTA	female
GCATGTACATGACGGA	male
GCATGTAGTAAAGTCA	male
GCATGTAGTACCGCTG	female
GCATGTAGTGTAAGTA	female
GCATGTAGTTGGTGGA	female
GCATGTATCGTTGACA	female
GCCAAATCACCAGCAC	female
GCCAAATCATGCATGT	male
GCCAAATGTACGAAAT	male
GCCAAATGTGTGACCC	female
GCCAAATTCACCAGGC	female
GCCTCTAAGACCTAGG	female
GCCTCTAAGTGTTAGA	male
GCCTCTACAGCTTAAC	male
GCCTCTACAGGGTACA	female
GCCTCTAGTGCCTGTG	male
GCCTCTATCATGTCCC	male
GCCTCTATCCTTTCTC	male
GCCTCTATCGCCTGTT	male
GCGACCAAGACCGGAT	female
GCGACCAAGACTAGGC	female
GCGACCAAGAGCTATA	male
GCGACCACATAAGACA	female
GCGACCATCCAATGGT	female
GCGAGAAAGAGTACAT	male
GCGAGAAAGCTAGTGG	male
GCGAGAAAGCTGATAA	male
GCGAGAACAACTTGAC	female
GCGAGAACACCTCGGA	female
GCGAGAACAGGCAGTA	female
GCGAGAACATCCTTGC	female
GCGAGAAGTAGCTTGT	female
GCGAGAAGTCGATTGT	male
GCGAGAAGTGGTCTCG	male
GCGAGAAGTTACTGAC	male
GCGAGAAGTTTCCACC	female
GCGAGAATCCGAAGAG	female
GCGAGAATCGCAAGCC	female
GCGAGAATCTTGAGAC	female
GCGCAACAGAAGATTC	male
GCGCAACAGCCCAGCT	male
GCGCAACAGCCTTGAT	male
GCGCAACAGGTGGGTT	female
GCGCAACAGTAACCCT	female
GCGCAACAGTATCTCG	female
GCGCAACAGTCATCCA	male
GCGCAACAGTTCGCGC	female
GCGCAACCACATCCAA	male
GCGCAACCACGACGAA	male
GCGCAACCACTGCCAG	female
GCGCAACGTTCAGCGC	female
GCGCAACTCAGCTTAG	female
GCGCAACTCCACTGGG	female
GCGCAGTAGAGTGACC	male
GCGCAGTCAACGATGG	male
GCGCAGTCACCTATCC	female
GCGCAGTCAGCTATTG	female
GCGCAGTCAGCTTAAC	female
GCGCAGTGTAACGACG	male
GCGCAGTGTCAAAGCG	male
GCGCAGTGTCCAGTTA	male
GCGCAGTGTGGGTCAA	female
GCGCAGTGTTCGTCTC	male
GCGCAGTGTTGGTTTG	male
GCGCAGTGTTGTGGCC	female
GCGCAGTTCAGTTGAC	female
GCGCAGTTCGGATGTT	male
GCGCAGTTCGGCATCG	male
GCGCAGTTCGTTGCCT	female
GCGCCAAAGAATGTTG	male
GCGCCAAAGATGTAAC	male
GCGCCAACACACGCTG	male
GCGCCAACAGATGGCA	female
GCGCCAACAGGTGGAT	female
GCGCCAAGTATGAATG	male
GCGCCAAGTCTGATCA	female
GCGCCAATCCTACAGA	male
GCGCGATAGACAGAGA	male
GCGCGATCAATAGAGT	male
GCGCGATCACATGTGT	male
GCGCGATCAGCGTCCA	female
GCGCGATCAGTTCATG	male
GCGCGATCATCCTTGC	female
GCGCGATGTACTCTCC	female
GCGCGATGTGAAAGAG	female
GCGCGATGTGTGTGCC	female
GCGCGATGTTCGGCAC	female
GCGCGATTCCACGAAT	male
GCGCGATTCGGTGTTA	male
GCGGGTTAGCTAGTGG	male
GCGGGTTAGGACAGCT	male
GCGGGTTAGGATGTAT	male
GCGGGTTAGTAGATGT	female
GCGGGTTCAACTTGAC	male
GCGGGTTCAATGGACG	male
GCGGGTTCACCCAGTG	female
GCGGGTTCAGTTCCCT	female
GCGGGTTCATAGACTC	male
GCGGGTTGTAATCGTC	male
GCGGGTTGTAGCTCCG	female
GCGGGTTGTCGAGATG	female
GCGGGTTGTCGAGTTT	male
GCGGGTTGTCTGGAGA	female
GCGGGTTGTTTAAGCC	female
GCGGGTTTCCTTCAAT	female
GCGGGTTTCTATGTGG	male
GCGGGTTTCTCTTATG	female
GCTCCTAAGTGGACGT	male
GCTCCTAAGTGGCACA	female
GCTCCTACACAGGCCT	male
GCTCCTACACCCAGTG	male
GCTCCTACAGACGTAG	male
GCTCCTACATGCCACG	female
GCTCCTACATGCCCGA	female
GCTCCTAGTCTCACCT	male
GCTCCTAGTCTTCAAG	male
GCTCCTAGTTTGACTG	female
GCTCCTATCAGAGGTG	female
GCTCCTATCCTAGAAC	male
GCTCCTATCCTCAATT	male
GCTCTGTAGAAGAAGC	female
GCTCTGTCAAGGTTCT	male
GCTCTGTCACCGATAT	male
GCTCTGTCACTTGGAT	male
GCTCTGTCAGTGGAGT	male
GCTCTGTGTCCGTGAC	female
GCTCTGTTCGCAAGCC	male
GCTCTGTTCGTCGTTC	male
GCTCTGTTCTGGCGAC	male
GCTGCAGAGCTAAGAT	male
GCTGCAGAGGAACTGC	male
GCTGCAGCAACAACCT	male
GCTGCAGGTCATGCCG	male
GCTGCAGGTCGTCTTC	male
GCTGCAGGTGCACTTA	male
GCTGCAGGTGCCTTGG	male
GCTGCAGTCTGGTATG	male
GCTGCAGTCTTGAGGT	female
GCTGCAGTCTTTCCTC	male
GCTGCGAAGAACAACT	female
GCTGCGAAGGAGTACC	female
GCTGCGAAGTACGCCC	male
GCTGCGACACGGTAAG	male
GCTGCGACAGCTTAAC	female
GCTGCGAGTTCGGCAC	male
GCTGCGATCCAGAAGG	female
GCTGCGATCCTAGTGA	female
GCTGCGATCGTTTATC	male
GCTGCTTAGTCCGGTC	female
GCTGCTTCAAGTACCT	male
GCTGCTTCACCCTATC	male
GCTGCTTCAGACTCGC	male
GCTGCTTCATCACAAC	female
GCTGCTTGTTGGTTTG	male
GCTGCTTTCACATAGC	female
GCTGCTTTCATGCTCC	female
GCTGCTTTCCTCTAGC	male
GCTGCTTTCGGTTAAC	male
GCTGGGTAGCAATATG	male
GCTGGGTAGTGTCCAT	male
GCTGGGTCACCATGTA	male
GCTGGGTCAGTACACT	female
GCTGGGTCATCGTCGG	female
GCTGGGTGTACTCAAC	male
GCTGGGTGTCATACTG	female
GCTGGGTGTCTGATCA	male
GCTGGGTGTGGTTTCA	female
GCTGGGTTCCCTAACC	male
GCTTCCAAGGGAAACA	female
GCTTCCACAACACCCG	male
GCTTCCACAAGCTGTT	male
GCTTCCACACGGTAAG	male
GCTTCCACAGCTGTTA	male
GCTTCCAGTCTTGCGG	female
GCTTCCAGTGAGGGTT	male
GCTTCCAGTTAGAACA	male
GCTTCCATCAAACGGG	female
GCTTCCATCCACGTGG	female
GCTTCCATCTGCGTAA	male
GCTTGAAAGCACAGGT	male
GCTTGAACAATGGTCT	female
GCTTGAACACTGTGTA	female
GCTTGAACAGATCGGA	female
GCTTGAAGTGAGGGTT	male
GCTTGAAGTTCCACTC	female
GCTTGAAGTTGGAGGT	male
GCTTGAATCATGTGGT	male
GCTTGAATCGCGGATC	male
GCTTGAATCTGCCCTA	male
GGAAAGCAGAGTCGGT	female
GGAAAGCCACCTATCC	male
GGAAAGCGTAAACGCG	male
GGAAAGCGTATCACCA	male
GGAAAGCGTCGAATCT	female
GGAAAGCGTTAGGGTG	male
GGAAAGCTCAGCACAT	male
GGAAAGCTCCGTTGCT	male
GGAAAGCTCGGAATCT	female
GGAACTTAGAATGTTG	male
GGAACTTAGAGGTACC	male
GGAACTTAGAGGTTAT	female
GGAACTTAGATAGCAT	female
GGAACTTAGCGAAGGG	male
GGAACTTCAATAGCAA	male
GGAACTTCAGATGGGT	male
GGAACTTCAGTCCTTC	male
GGAACTTGTAGTAGTA	male
GGAACTTGTCCTAGCG	female
GGAACTTTCAACGGGA	male
GGAACTTTCGCATGGC	male
GGAACTTTCTCAAACG	female
GGAATAAAGGGTTCCC	male
GGAATAAGTCCTCTTG	male
GGAATAAGTCTCATCC	male
GGAATAAGTTTGGCGC	female
GGAATAATCACCGTAA	female
GGACAAGAGAAGAAGC	female
GGACAAGAGTCGATAA	male
GGACAAGCACAAGTAA	female
GGACAAGCACAGTCGC	female
GGACAAGCACGACTCG	female
GGACAAGCATGTCCTC	male
GGACAAGCATTCTCAT	male
GGACAAGGTAGCAAAT	female
GGACAAGGTTAAGAAC	male
GGACAAGGTTACCGAT	male
GGACAGACATACTCTT	male
GGACAGACATCCAACA	male
GGACAGAGTACGAAAT	male
GGACAGAGTTCGTTGA	female
GGACAGATCATCGCTC	male
GGACATTAGATGTCGG	male
GGACATTAGTACGTTC	male
GGACATTAGTATTGGA	male
GGACATTCAAGGACTG	female
GGACATTCACGTTGGC	male
GGACATTCAGGGTATG	female
GGACATTGTATATGAG	female
GGACATTGTGTCGCTG	female
GGACATTGTTTGGGCC	male
GGACATTTCAGGCAAG	male
GGACATTTCATCGCTC	female
GGACATTTCCCTCAGT	male
GGACATTTCCGCATCT	male
GGACATTTCTGCTGTC	female
GGACGTCAGCGAAGGG	male
GGACGTCCACCAGGCT	male
GGACGTCCACCCATGG	female
GGACGTCCACGAAACG	female
GGACGTCCACGTAAGG	female
GGACGTCGTATCACCA	male
GGACGTCTCAAGGTAA	female
GGACGTCTCATACGGT	female
GGACGTCTCCGTCAAA	male
GGACGTCTCCTAGAAC	female
GGACGTCTCGTTACGA	male
GGAGCAAAGACTTTCG	male
GGAGCAAAGGCTATCT	male
GGAGCAAAGTAACCCT	female
GGAGCAAAGTGATCGG	male
GGAGCAACAAACTGTC	male
GGAGCAACAACGATGG	female
GGAGCAACAGGAATCG	male
GGAGCAACAGGTCCAC	male
GGAGCAAGTCATGCCG	female
GGAGCAAGTCGGGTCT	male
GGAGCAAGTCTAGTGT	female
GGAGCAAGTTCGAATC	male
GGAGCAAGTTGGTGGA	female
GGAGCAAGTTTGTTGG	female
GGAGCAATCGCAGGCT	female
GGAGCAATCGTCTGCT	female
GGAGCAATCTTGACGA	female
GGATGTTAGAAACGCC	male
GGATGTTAGTACGACG	female
GGATGTTCACGGATAG	male
GGATGTTCACGGTAGA	female
GGATGTTCACTGTTAG	female
GGATGTTGTAAACGCG	male
GGATGTTGTAAGGATT	male
GGATGTTGTCCCTACT	male
GGATGTTTCAAACAAG	male
GGATTACAGATCGGGT	male
GGATTACAGCACCGCT	male
GGATTACAGCGTGTCC	male
GGATTACCACTAAGTC	male
GGATTACGTAACGTTC	male
GGATTACTCACCTCGT	female
GGATTACTCGCCAAAT	female
GGATTACTCTCCAACC	male
GGATTACTCTGCCCTA	male
GGCAATTAGACTTGAA	female
GGCAATTAGTAATCCC	male
GGCAATTCAAGCTGAG	male
GGCAATTCAATAACGA	female
GGCAATTCAGTATGCT	male
GGCAATTCATCGATTG	male
GGCAATTGTAGGGTAC	female
GGCAATTGTCGTGGCT	male
GGCAATTGTGACAAAT	male
GGCAATTGTTAGTGGG	male
GGCAATTTCAGCTCTC	female
GGCAATTTCTTTAGGG	male
GGCCGATAGGGCTCTC	male
GGCCGATCAGATGAGC	female
GGCCGATGTCATGCCG	male
GGCCGATGTCTAAACC	male
GGCCGATTCACCGGGT	male
GGCCGATTCCTTTCTC	female
GGCCGATTCGCAAACT	male
GGCGACTAGACTGGGT	male
GGCGACTAGGATGTAT	male
GGCGACTAGTCCCACG	female
GGCGACTCACTCTGTC	male
GGCGACTCATCATCCC	male
GGCGACTCATGGATGG	male
GGCGACTGTAATCACC	female
GGCGACTTCAGGCCCA	male
GGCGACTTCGGCGCAT	male
GGCGACTTCTTTCCTC	male
GGCGTGTCATGTTCCC	female
GGCGTGTGTCATGCAT	female
GGCGTGTGTTAGTGGG	male
GGCGTGTTCAGTCCCT	male
GGCGTGTTCATAAAGG	female
GGCGTGTTCATAACCG	male
GGCGTGTTCCTATGTT	male
GGCTCGAAGAGTTGGC	female
GGCTCGAAGGCTCTTA	female
GGCTCGAAGTATCGAA	male
GGCTCGAAGTGGAGAA	male
GGCTCGACAATTGCTG	female
GGCTCGACAGACGCTC	male
GGCTCGATCAAACGGG	female
GGCTCGATCGCTTGTC	male
GGCTCGATCTTGTACT	male
GGCTGGTAGCCACGTC	male
GGCTGGTAGGGATCTG	male
GGCTGGTAGTACGCGA	male
GGCTGGTAGTGTACGG	male
GGCTGGTCAAGTCTAC	female
GGCTGGTCATCTATGG	female
GGCTGGTGTCCGAACC	female
GGCTGGTGTTCAACCA	female
GGCTGGTTCACGAAGG	male
GGCTGGTTCCGTACAA	female
GGCTGGTTCCTTTCTC	female
GGCTGGTTCGACCAGC	male
GGCTGGTTCTTCATGT	male
GGGAATGAGAGTACCG	female
GGGAATGCACACATGT	male
GGGAATGCAGGAATCG	female
GGGAATGGTCTCCCTA	female
GGGAATGGTCTGATCA	male
GGGAATGTCATCGCTC	female
GGGAATGTCGGTCTAA	female
GGGAATGTCTGGCGTG	male
GGGACCTAGTGTTAGA	male
GGGACCTCACGCCAGT	female
GGGACCTGTGAGGCTA	male
GGGACCTGTGATGCCC	male
GGGACCTGTGGCAAAC	female
GGGACCTTCCCTGACT	male
GGGACCTTCGGCGCAT	male
GGGACCTTCGTGGGAA	female
GGGAGATAGGGAACGG	male
GGGAGATAGGTTCCTA	female
GGGAGATCAACACCTA	female
GGGAGATCAATGACCT	male
GGGAGATCACGAAGCA	male
GGGAGATCAGAGCCAA	male
GGGAGATCAGTCCTTC	female
GGGAGATGTACAGCAG	female
GGGAGATGTGACTCAT	male
GGGAGATGTGTCGCTG	male
GGGAGATGTGTGCGTC	male
GGGAGATGTTTCCACC	female
GGGAGATTCGAGCCCA	female
GGGAGATTCGTACCGG	male
GGGAGATTCTCGAGTA	female
GGGATGAAGACTAGGC	male
GGGATGAAGAGGGCTT	female
GGGATGAAGAGTCGGT	female
GGGATGAAGCCCGAAA	male
GGGATGACAAGGTGTG	female
GGGATGACACATTTCT	male
GGGATGAGTCCGTCAG	male
GGGATGAGTCGAACAG	male
GGGATGATCCACGAAT	male
GGGATGATCGGCTACG	male
GGGCACTAGTGTACCT	female
GGGCACTCATGGGACA	male
GGGCACTGTCTGGAGA	female
GGGCACTGTGTAAGTA	female
GGGCACTTCACATACG	female
GGGCACTTCATGTAGC	female
GGGCACTTCCAAGTAC	male
GGGCACTTCGACGGAA	female
GGGCACTTCGTCCGTT	female
GGGCACTTCTATCCCG	female
GGGCATCAGAATTGTG	male
GGGCATCAGATAGTCA	male
GGGCATCAGGAACTGC	female
GGGCATCAGGGAGTAA	male
GGGCATCCACCCATGG	male
GGGCATCGTCATCCCT	female
GGGCATCGTGGCTCCA	female
GGGCATCTCTCTTGAT	male
GGGTCTGAGAGCCTAG	male
GGGTCTGAGTGGAGAA	male
GGGTCTGCACCGTTGG	female
GGGTCTGGTAGATTAG	male
GGGTCTGGTCACACGC	male
GGGTCTGTCCACGCAG	female
GGGTCTGTCCACTCCA	male
GGGTTGCAGGGCACTA	female
GGGTTGCAGTGCCATT	male
GGGTTGCCAGACAGGT	female
GGGTTGCCAGGCTGAA	male
GGGTTGCGTATAGTAG	female
GGGTTGCGTGCCTGGT	male
GGGTTGCTCAGGTAAA	female
GGGTTGCTCATTGCCC	female
GGGTTGCTCTCCTATA	male
GGTATTGAGATGAGAG	male
GGTATTGAGCAATCTC	male
GGTATTGAGCGTGTCC	male
GGTATTGAGCTGCGAA	male
GGTATTGAGTACCGGA	male
GGTATTGAGTCGAGTG	male
GGTATTGAGTGCCATT	female
GGTATTGCAAGTAATG	female
GGTATTGCACAAGACG	male
GGTATTGCAGCCTGTG	male
GGTATTGTCATATCGG	male
GGTATTGTCCTATGTT	male
GGTGAAGAGGCGACAT	male
GGTGAAGCAGCATGAG	male
GGTGAAGCATATGAGA	male
GGTGAAGGTAGGCATG	male
GGTGAAGGTGTGGTTT	male
GGTGAAGGTTGGAGGT	male
GGTGAAGTCAGTTTGG	female
GGTGAAGTCGCAAGCC	male
GGTGCGTAGCGTCTAT	female
GGTGCGTAGGCGTACA	male
GGTGCGTAGGCTCTTA	female
GGTGCGTAGTCACGCC	male
GGTGCGTAGTGCCAGA	male
GGTGCGTAGTGGGCTA	male
GGTGCGTCACATAACC	male
GGTGCGTCACTGTCGG	male
GGTGCGTGTCATGCCG	female
GGTGCGTGTGCCTGGT	male
GGTGCGTTCAACGCTA	female
GGTGCGTTCCCTCTTT	male
GGTGTTAAGAAGGACA	male
GGTGTTAAGCCTTGAT	male
GGTGTTAAGCGATCCC	female
GGTGTTAAGTGAACGC	female
GGTGTTACAAGTAGTA	male
GGTGTTACACGAAAGC	male
GGTGTTAGTCATCGGC	female
GGTGTTATCAGCACAT	female
GGTGTTATCCGTTGCT	female
GTAACGTAGATCCTGT	male
GTAACGTAGGTACTCT	female
GTAACGTAGTAAGTAC	male
GTAACGTGTACCGAGA	female
GTAACGTGTGGGTATG	male
GTAACTGAGATGCCAG	female
GTAACTGAGGCTCTTA	female
GTAACTGCAAATTGCC	female
GTAACTGCAAGGTTTC	male
GTAACTGCAATCACAC	male
GTAACTGCAATGGAGC	female
GTAACTGCAGCTCCGA	male
GTAACTGGTAGTAGTA	female
GTACGTAAGCAGGCTA	male
GTACGTAAGTCCCACG	female
GTACGTACATGTCCTC	female
GTACGTAGTCACACGC	female
GTACGTATCCCAACGG	male
GTACGTATCGACCAGC	female
GTACGTATCGTCACGG	male
GTACGTATCGTGGACC	female
GTACTCCCACATGGGA	male
GTACTCCGTCACCTAA	male
GTACTCCGTCTCATCC	female
GTACTCCTCATGGTCA	male
GTACTCCTCCATGCTC	male
GTACTTTAGGAGCGAG	female
GTACTTTAGGCGACAT	male
GTACTTTAGTACCGGA	male
GTACTTTCACCAGATT	male
GTACTTTCAGCTTCGG	female
GTACTTTCATGATCCA	male
GTACTTTTCAATAAGG	female
GTACTTTTCCAGATCA	female
GTACTTTTCGCGTTTC	female
GTACTTTTCTACTATC	male
GTAGGCCAGCGCTTAT	male
GTAGGCCCAATAGCGG	female
GTAGGCCCACCGAATT	female
GTAGGCCCAGGACGTA	male
GTAGGCCGTGTGGCTC	female
GTAGGCCTCAAACGGG	male
GTAGGCCTCACCCTCA	female
GTAGGCCTCACTCTTA	female
GTAGGCCTCATCGGAT	male
GTAGGCCTCCACGACG	male
GTAGGCCTCGAGAACG	female
GTAGGCCTCTCCAACC	male
GTAGTCACACACAGAG	female
GTAGTCACACCCATGG	female
GTAGTCAGTTCAACCA	male
GTAGTCATCAACACGT	female
GTAGTCATCGCAAGCC	female
GTAGTCATCGCCAGCA	male
GTATCTTAGACTTGAA	female
GTATCTTAGAGTCTGG	male
GTATCTTAGGGATGGG	male
GTATCTTCACAACTGT	female
GTATCTTGTCGATTGT	female
GTATCTTGTCGGGTCT	female
GTATTCTAGGCTAGGT	male
GTATTCTAGTCCATAC	male
GTATTCTAGTGTGAAT	male
GTATTCTAGTTGTAGA	female
GTATTCTCAATGCCAT	female
GTATTCTCAATGGAGC	male
GTATTCTGTTAAGACA	male
GTATTCTTCATATCGG	male
GTATTCTTCCTTCAAT	female
GTATTCTTCTACTCAT	female
GTCAAGTAGAAGGACA	male
GTCAAGTCATAACCTG	male
GTCAAGTCATGTCCTC	female
GTCAAGTCATTGCGGC	female
GTCAAGTGTAATTGGA	male
GTCAAGTGTCTACCTC	female
GTCAAGTGTGCAGACA	male
GTCAAGTGTTACCGAT	female
GTCAAGTTCATGTGGT	male
GTCAAGTTCGTGACAT	female
GTCAAGTTCTGCGACG	female
GTCACAAAGAACAACT	male
GTCACAAAGACATAAC	male
GTCACAAAGATAGGAG	female
GTCACAAAGCTCCTTC	male
GTCACAACACGCATCG	male
GTCACAAGTAGCCTCG	female
GTCACAAGTCTGCAAT	female
GTCACAATCTTAACCT	female
GTCACAATCTTGAGAC	female
GTCACGGAGAGCCCAA	male
GTCACGGCAAAGGCGT	female
GTCACGGCATCAGTCA	male
GTCACGGGTAGCGATG	female
GTCACGGGTCAGAGGT	male
GTCACGGGTTTGCATG	female
GTCACGGTCAACTCTT	male
GTCACGGTCAGCCTAA	female
GTCACGGTCCAAACTG	male
GTCACGGTCCACGTGG	male
GTCACGGTCTACTATC	male
GTCATTTAGAGGGCTT	male
GTCATTTAGTCTCAAC	female
GTCATTTAGTGGCACA	female
GTCATTTAGTGTCCAT	male
GTCATTTAGTTAACGA	female
GTCCTCAAGAGGTTAT	male
GTCCTCAAGCAATATG	female
GTCCTCAAGCTAACAA	male
GTCCTCAAGCTGTTCA	male
GTCCTCAAGGCCCGTT	female
GTCCTCACAATAACGA	female
GTCCTCACAATAGAGT	female
GTCCTCACACGAAATA	female
GTCCTCACAGGGTTAG	male
GTCCTCACATGCTGGC	female
GTCCTCAGTCATACTG	female
GTCCTCATCATCACCC	male
GTCCTCATCCCAAGTA	female
GTCCTCATCCCGACTT	male
GTCCTCATCCCTTGCA	female
GTCCTCATCCTCGCAT	male
GTCCTCATCTAACGGT	female
GTCCTCATCTCCGGTT	female
GTCGGGTAGAAGATTC	male
GTCGGGTCACTACAGT	male
GTCGGGTGTCTTGATG	male
GTCGGGTTCTTGGGTA	male
GTCGTAACATCGGGTC	male
GTCGTAACATCGTCGG	male
GTCGTAAGTGCGATAG	female
GTCGTAAGTTTAGGAA	male
GTCGTAATCCTTTCTC	female
GTCTCGTAGATATGCA	male
GTCTCGTAGCGATAGC	male
GTCTCGTCATCTACGA	female
GTCTCGTCATCTGGTA	female
GTCTCGTGTGCAGTAG	male
GTCTCGTGTTGGACCC	male
GTCTCGTTCGCTTAGA	female
GTCTTCGAGCCCGAAA	male
GTCTTCGAGGCCGAAT	male
GTCTTCGCACAAGACG	male
GTCTTCGCAGCATACT	female
GTCTTCGCAGTATCTG	male
GTCTTCGGTCCTGCTT	male
GTCTTCGGTGCACGAA	male
GTCTTCGGTGTTCGAT	male
GTCTTCGTCAGTCAGT	female
GTCTTCGTCCTCTAGC	female
GTCTTCGTCGCCGTGA	male
GTCTTCGTCTCTGAGA	female
GTGAAGGAGAAACCAT	female
GTGAAGGCAAGAAGAG	female
GTGAAGGCACTTCGAA	male
GTGAAGGGTACAGCAG	male
GTGAAGGGTCCGAATT	male
GTGAAGGTCATATCGG	male
GTGAAGGTCCTGCCAT	female
GTGAAGGTCGCTAGCG	female
GTGCAGCAGACTGGGT	female
GTGCAGCAGCGTAGTG	male
GTGCAGCAGGTGTGGT	male
GTGCAGCAGTTCGCAT	male
GTGCAGCCACAACGCC	male
GTGCAGCGTATGGTTC	female
GTGCAGCGTCTGATTG	male
GTGCAGCGTGATAAGT	male
GTGCAGCGTGCCTGGT	female
GTGCAGCGTTCCAACA	male
GTGCAGCTCACCGTAA	female
GTGCAGCTCATCGGAT	male
GTGCAGCTCGGAATCT	male
GTGCAGCTCTCGCTTG	male
GTGCATAAGAACAATC	male
GTGCATAAGGGATCTG	male
GTGCATAAGGTAGCCA	female
GTGCATAAGTCACGCC	female
GTGCATACAAGGGTCA	male
GTGCATACAGTCCTTC	male
GTGCATAGTTACGACT	female
GTGCATAGTTCATGGT	male
GTGCATATCGCGTAGC	female
GTGCATATCTGATACG	female
GTGCGGTAGAAACCGC	male
GTGCGGTAGAGGTTGC	female
GTGCGGTAGATGTGGC	male
GTGCGGTCAGCTGTTA	male
GTGCGGTCATCCCACT	female
GTGCGGTCATGAACCT	male
GTGCGGTCATGCCTTC	female
GTGCGGTGTAGCACGA	male
GTGCGGTGTCGACTGC	male
GTGCGGTGTTAGGGTG	male
GTGCGGTTCTACCTGC	female
GTGCTTCAGAGCAATT	male
GTGCTTCAGCGTCAAG	female
GTGCTTCAGCTTATCG	female
GTGCTTCCAATGGATA	female
GTGCTTCCAGCCTGTG	male
GTGCTTCCAGCTCGAC	male
GTGCTTCGTCTGGAGA	male
GTGCTTCTCACATACG	male
GTGCTTCTCCCGACTT	female
GTGCTTCTCCGATATG	male
GTGCTTCTCTGGAGCC	male
GTGGGTCAGGCCGAAT	male
GTGGGTCCAAGTCATC	female
GTGGGTCCACGGTTTA	male
GTGGGTCCAGCTATTG	male
GTGGGTCGTCAGAGGT	female
GTGGGTCGTCGATTGT	male
GTGGGTCGTCTTTCAT	male
GTGGGTCTCGAATGGG	male
GTGGGTCTCTCTAGGA	male
GTGTGCGAGAAGCCCA	male
GTGTGCGAGCACGCCT	male
GTGTGCGAGCTACCTA	female
GTGTGCGCATAGTAAG	female
GTGTGCGGTCTCACCT	male
GTGTGCGTCACGATGT	female
GTGTGCGTCATAAAGG	female
GTGTGCGTCTGCTGTC	female
GTGTTAGAGGGTATCG	female
GTGTTAGAGTAGGTGC	female
GTGTTAGAGTGTGGCA	male
GTGTTAGCAGGAATCG	male
GTGTTAGCATGTCTCC	male
GTGTTAGGTGCTCTTC	male
GTTAAGCAGACTTGAA	female
GTTAAGCAGATGCGAC	female
GTTAAGCAGTACGTTC	male
GTTAAGCGTATGGTTC	female
GTTAAGCGTGCGATAG	male
GTTAAGCTCAAACCGT	female
GTTAAGCTCAACCATG	female
GTTAAGCTCCATGCTC	male
GTTAAGCTCCGCAAGC	male
GTTACAGAGAATTGTG	male
GTTACAGCACTTGGAT	male
GTTACAGGTACAAGTA	male
GTTACAGTCCTGCCAT	female
GTTCATTAGGTTACCT	female
GTTCATTCACCTATCC	male
GTTCATTGTAAAGGAG	male
GTTCATTGTCACAAGG	female
GTTCATTGTCATCGGC	female
GTTCATTGTCTGCGGT	female
GTTCATTGTGCACGAA	female
GTTCATTTCACGACTA	female
GTTCATTTCCCTAACC	female
GTTCGGGAGAAGAAGC	female
GTTCGGGAGCATGGCA	female
GTTCGGGCATTGAGCT	male
GTTCGGGGTCTCAACA	female
GTTCGGGGTGCCTGTG	male
GTTCGGGGTTCTCATT	male
GTTCGGGGTTGGACCC	male
GTTCGGGTCTGGCGTG	male
GTTCTCGAGTACGCGA	female
GTTCTCGCAACAACCT	male
GTTCTCGCAATGGACG	male
GTTCTCGCAATGGATA	female
GTTCTCGGTAGCCTCG	female
GTTCTCGGTCATATGC	male
GTTCTCGGTGACGGTA	male
GTTCTCGGTTCAGGCC	male
GTTCTCGGTTGATTCG	female
GTTCTCGTCAAACAAG	male
GTTCTCGTCTACCTGC	male
GTTTCTAAGAGTCTGG	female
GTTTCTAAGGACACCA	female
GTTTCTACAATGGATA	male
GTTTCTACACAGACTT	male
GTTTCTACACAGTCGC	male
GTTTCTACACGCGAAA	male
GTTTCTACAGTCAGAG	male
GTTTCTACATGAACCT	male
GTTTCTAGTAGCGATG	male
GTTTCTAGTGGTCTCG	female
GTTTCTAGTTCCACGG	female
GTTTCTAGTTCTGAAC	male
GTTTCTATCAGTTAGC	male
GTTTCTATCGACGGAA	male
TAAACCGAGGAGTAGA	female
TAAACCGAGTATGACA	male
TAAACCGCAACACGCC	female
TAAACCGCACCTCGTT	female
TAAACCGCAGGCAGTA	female
TAAACCGCAGTCAGAG	male
TAAACCGGTACAGCAG	male
TAAACCGGTGTGTGCC	male
TAAACCGGTTAAGATG	male
TAAACCGGTTCATGGT	male
TAAACCGTCACATAGC	male
TAAACCGTCACCCTCA	male
TAAACCGTCCGCAGTG	male
TAAACCGTCCTAAGTG	male
TAAGAGAAGAGAGCTC	female
TAAGAGAAGCTATGCT	male
TAAGAGAAGTGTTTGC	female
TAAGAGACAGCTGCTG	male
TAAGAGATCAGTGTTG	male
TAAGAGATCGTCGTTC	female
TAAGCGTAGACGACGT	male
TAAGCGTAGAGGGCTT	female
TAAGCGTCAATGGTCT	female
TAAGCGTCACACTGCG	female
TAAGCGTCAGCTGCAC	male
TAAGCGTGTCTAGCGC	female
TAAGCGTGTGTGACGA	female
TAAGCGTGTTACGCGC	female
TAAGTGCAGATATGGT	male
TAAGTGCAGATCCGAG	male
TAAGTGCAGGCCATAG	female
TAAGTGCCAAGTCTAC	male
TAAGTGCCACATCCGG	male
TAAGTGCCATGTTCCC	female
TAAGTGCGTACAAGTA	female
TAAGTGCGTAGGAGTC	female
TAAGTGCGTGAAAGAG	female
TAAGTGCGTGTTCTTT	male
TAAGTGCTCCTATTCA	male
TAAGTGCTCGTTACGA	male
TACACGAAGAGGTAGA	male
TACACGAAGTGGTCCC	female
TACACGACACGTCAGC	male
TACACGACAGACAGGT	male
TACACGACATACAGCT	female
TACACGACATCACGAT	male
TACACGAGTCTACCTC	male
TACACGAGTGACCAAG	male
TACACGATCAACTCTT	female
TACAGTGAGACGCACA	female
TACAGTGAGGGCACTA	female
TACAGTGAGTGGCACA	female
TACAGTGCAGGGTTAG	female
TACAGTGCATTCGACA	male
TACAGTGTCAACTCTT	male
TACAGTGTCACTATTC	female
TACAGTGTCCCTCAGT	male
TACAGTGTCGCACTCT	male
TACCTATAGAAAGTGG	female
TACCTATAGAAGGTTT	female
TACCTATAGCACCGTC	male
TACCTATAGCCAGTTT	female
TACCTATAGTACGACG	female
TACCTATAGTCTTGCA	female
TACCTATCATAGTAAG	female
TACCTATGTATGAATG	male
TACCTATGTTAGGGTG	male
TACCTATTCATCACCC	male
TACCTTAAGAAGGCCT	female
TACCTTAAGAGCTTCT	male
TACCTTAAGCTAACAA	female
TACCTTAAGCTGTTCA	male
TACCTTACAAGCCATT	female
TACCTTACAGTACACT	female
TACCTTAGTTCCATGA	female
TACCTTATCCTAAGTG	male
TACCTTATCCTTGGTC	male
TACCTTATCGGATGGA	male
TACCTTATCTTTCCTC	female
TACGGATAGCCAGTTT	female
TACGGATAGCGATGAC	male
TACGGATAGTTGTCGT	female
TACGGATGTCACCCAG	male
TACGGATTCTCGCATC	female
TACGGATTCTGTCAAG	male
TACGGATTCTGTTTGT	female
TACGGGCAGCCCAATT	female
TACGGGCAGCGAAGGG	female
TACGGGCAGCTGGAAC	male
TACGGGCCAATGAATG	female
TACGGGCCACCTCGTT	female
TACGGGCCAGTGACAG	female
TACGGGCCATCGGTTA	male
TACGGGCGTTTGGCGC	male
TACGGGCTCAGCTCGG	male
TACGGGCTCATGCAAC	female
TACGGGCTCCCTAATT	female
TACGGTAAGAAACCTA	female
TACGGTAAGAAGGTTT	female
TACGGTAAGAGGGATA	female
TACGGTAAGAGTACAT	male
TACGGTAAGATTACCC	male
TACGGTAAGCGCCTCA	male
TACGGTACAGTGGGAT	female
TACGGTAGTCACCCAG	female
TACGGTAGTCCGAAGA	male
TACGGTAGTGCTAGCC	male
TACGGTAGTGTCTGAT	male
TACGGTATCAAGGTAA	male
TACGGTATCTAACTTC	male
TACTCATCAACACGCC	male
TACTCATCAAGGACTG	male
TACTCATCAATGGAGC	male
TACTCATGTAAACCTC	male
TACTCATGTGGCTCCA	female
TACTCATTCCCTAATT	male
TACTCATTCGTGGGAA	male
TACTCATTCTGACCTC	male
TACTCGCAGATGGGTC	female
TACTCGCAGCGGATCA	male
TACTCGCAGCTGCCCA	male
TACTCGCCAAATCCGT	female
TACTCGCCATGTTCCC	male
TACTCGCCATTCTTAC	male
TACTCGCGTTTGGCGC	male
TACTCGCTCACTCCTG	male
TACTCGCTCTGGTATG	male
TACTCGCTCTGTCTCG	male
TACTTACAGAGATGAG	male
TACTTACAGGAACTGC	male
TACTTACAGTACGCGA	female
TACTTACAGTGTACTC	male
TACTTACCACGTTGGC	female
TACTTACCACTCGACG	female
TACTTACCAGGTCTCG	female
TACTTACCAGTCAGAG	female
TACTTACGTAGCGTGA	male
TACTTACGTAGCTCCG	female
TACTTACGTTACGGAG	male
TACTTACGTTCAACCA	female
TACTTACTCGTTTAGG	male
TACTTGTAGGGATGGG	female
TACTTGTCAGACGCCT	female
TACTTGTCAGATCCAT	male
TACTTGTCAGATCGGA	male
TACTTGTGTAATCGTC	female
TAGACCAAGAACAATC	female
TAGACCAAGCTAACAA	male
TAGACCAAGCTAGGCA	female
TAGACCAAGCTTCGCG	female
TAGACCAAGGATTCGG	male
TAGACCACAACGATGG	male
TAGACCACACGCCAGT	male
TAGACCAGTGTCCTCT	female
TAGACCATCAGTGCAT	male
TAGACCATCGAATGCT	male
TAGACCATCTGTCTAT	female
TAGAGCTAGACTAGAT	female
TAGAGCTAGGCTAGGT	female
TAGAGCTCAAAGCGGT	female
TAGAGCTCATTGGTAC	male
TAGAGCTGTATAGGGC	male
TAGAGCTGTGAAGGCT	male
TAGAGCTGTGTGCCTG	male
TAGAGCTTCAACGCTA	female
TAGAGCTTCAGTACGT	female
TAGCCGGAGACTGGGT	male
TAGCCGGAGTTCGCAT	male
TAGCCGGAGTTGAGTA	female
TAGCCGGCAAACCTAC	female
TAGCCGGCAACGCACC	male
TAGCCGGCACATGGGA	male
TAGCCGGCACGGCGTT	male
TAGCCGGCATCGACGC	male
TAGCCGGGTAATAGCA	male
TAGCCGGGTGTCTGAT	male
TAGCCGGGTGTTCGAT	male
TAGCCGGGTTAAGAAC	male
TAGGCATAGAGAACAG	male
TAGGCATAGTGGGCTA	male
TAGGCATAGTTTGCGT	male
TAGGCATCAACTGGCC	female
TAGGCATCAATGAATG	male
TAGGCATCATATGCTG	female
TAGGCATGTCTAGTCA	male
TAGGCATTCCAAAGTC	female
TAGTGGTAGAGTCTGG	female
TAGTGGTAGAGTTGGC	male
TAGTGGTAGGGATCTG	male
TAGTGGTAGTAGGTGC	male
TAGTGGTCAAGTTCTG	female
TAGTGGTCACAGGCCT	female
TAGTGGTCAGCCTGTG	female
TAGTGGTCAGCTCGAC	male
TAGTGGTCATGGAATA	female
TAGTGGTGTCACACGC	female
TAGTGGTGTGATAAAC	male
TAGTGGTTCCCAGGTG	female
TAGTGGTTCCCTAATT	male
TAGTGGTTCTTAGCCC	female
TAGTTGGAGAGTAATC	male
TAGTTGGAGTACGTTC	female
TAGTTGGAGTGGAGTC	male
TAGTTGGCAAGCCATT	male
TAGTTGGCAGCCTGTG	male
TAGTTGGCAGTCAGAG	female
TAGTTGGGTCGAAAGC	male
TAGTTGGGTTTGTGTG	female
TAGTTGGTCATTCACT	male
TAGTTGGTCATTTGGG	male
TAGTTGGTCGCGTAGC	male
TAGTTGGTCTGCAGTA	female
TATCAGGAGACAAAGG	male
TATCAGGAGAGGTAGA	male
TATCAGGAGAGTCGGT	female
TATCAGGAGCTAGCCC	male
TATCAGGCAATGCCAT	male
TATCAGGGTCAAACTC	female
TATCAGGGTCACTTCC	male
TATCAGGTCCTGCTTG	male
TATCAGGTCGGCGCAT	female
TATCAGGTCGTTTAGG	female
TATCAGGTCTCCAGGG	male
TATCTCAAGGAGCGAG	female
TATCTCAAGTCCTCCT	female
TATCTCACACATCCGG	male
TATCTCACAGCAGTTT	male
TATCTCACAGGGAGAG	female
TATCTCACATTAGCCA	male
TATCTCATCTGTTGAG	female
TATCTCATCTTCCTTC	female
TATGCCCAGGTGCTAG	female
TATGCCCCAATTCCTT	female
TATGCCCCACAACGTT	female
TATGCCCGTAGCGTCC	female
TATGCCCGTAGCTTGT	male
TATGCCCTCAGCTTAG	female
TATGCCCTCATCTGTT	female
TATTACCAGGTGATAT	female
TATTACCCACCCAGTG	female
TATTACCCACGAAAGC	male
TATTACCCAGTTCATG	male
TATTACCGTACCATCA	male
TATTACCGTATATGGA	male
TATTACCGTCAGCTAT	female
TATTACCTCAGCTTAG	male
TCAACGAAGCCAGTTT	male
TCAACGAAGGCTATCT	male
TCAACGAAGGGCATGT	male
TCAACGACACGAAACG	female
TCAACGAGTACTTCTT	female
TCAACGAGTCTGCAAT	female
TCAACGAGTGCACCAC	male
TCAACGATCAACCATG	female
TCAACGATCAGCACAT	female
TCAACGATCCGGCACA	male
TCAACGATCGGTTCGG	male
TCAACGATCGTACGGC	male
TCAACGATCTTTAGTC	male
TCAATCTAGCGTCTAT	female
TCAATCTCACGCATCG	female
TCAATCTGTATAGGGC	female
TCAATCTGTCAAAGAT	male
TCAATCTGTCAGAATA	female
TCAATCTGTGCTCTTC	female
TCAATCTGTGGCAAAC	male
TCAATCTTCAAGATCC	male
TCAATCTTCCAAGTAC	male
TCACAAGAGATATGCA	male
TCACAAGAGGGTGTTG	male
TCACAAGCAATACGCT	female
TCACAAGCATCAGTCA	male
TCACAAGCATCCAACA	female
TCACAAGGTAGAGCTG	male
TCACAAGGTAGCAAAT	male
TCACAAGGTGCCTGCA	female
TCACAAGGTGGAAAGA	female
TCACAAGGTTACAGAA	female
TCACAAGGTTACCAGT	female
TCACAAGTCCTGTAGA	female
TCACAAGTCTGGCGAC	male
TCACGAAAGGCAGTCA	male
TCACGAACAACACGCC	male
TCACGAAGTCTAGCCG	female
TCACGAAGTGCAACTT	male
TCACGAAGTTAAAGTG	female
TCACGAATCGTTGACA	female
TCAGATGAGCACGCCT	male
TCAGATGAGTACGATA	male
TCAGATGAGTTTGCGT	female
TCAGATGCACAAGACG	female
TCAGATGCACCGCTAG	female
TCAGATGCAGCTTAAC	male
TCAGATGCATCACCCT	male
TCAGATGCATCGGAAG	female
TCAGATGCATGAGCGA	male
TCAGATGCATGCAATC	male
TCAGATGTCACAATGC	female
TCAGATGTCATAAAGG	male
TCAGCAAAGACTAAGT	female
TCAGCAACAAGACACG	female
TCAGCAACACCGCTAG	male
TCAGCAACATAGGATA	male
TCAGCAAGTCTCCACT	male
TCAGCAATCAACACCA	female
TCAGCTCAGGCCCTCA	male
TCAGCTCAGTCAAGGC	female
TCAGCTCCAAGTAATG	male
TCAGCTCCAGGTCGTC	female
TCAGCTCGTACCGGCT	male
TCAGCTCGTATAGTAG	male
TCAGCTCGTATGCTTG	male
TCAGCTCGTTGATTCG	female
TCAGCTCTCATGCAAC	female
TCAGCTCTCGTCACGG	male
TCAGCTCTCTAGAGTC	male
TCAGGATAGAAGGGTA	male
TCAGGATAGATCTGAA	male
TCAGGATAGGAGTTTA	male
TCAGGATAGTACATGA	female
TCAGGATCACTGTCGG	female
TCAGGATCAGATAATG	female
TCAGGATCAGTGACAG	male
TCAGGATGTGCCTGTG	male
TCAGGATTCAAAGACA	male
TCAGGATTCAGCTTAG	male
TCAGGATTCCAACCAA	male
TCAGGATTCCGTACAA	male
TCAGGATTCTGGGCCA	female
TCAGGTAAGGTAAACT	male
TCAGGTAAGTGAAGAG	female
TCAGGTACAAATACAG	male
TCAGGTACAGTACACT	female
TCAGGTACATTGGTAC	male
TCAGGTATCGTTGCCT	male
TCAGGTATCTGTCTCG	male
TCATTACAGCCAGGAT	male
TCATTACAGCTACCGC	female
TCATTACCAACGCACC	male
TCATTACCACACCGAC	female
TCATTACCACTTCTGC	male
TCATTACCAGAGTGTG	female
TCATTACGTAGAGGAA	male
TCATTACGTGCTTCTC	male
TCATTACTCAAACAAG	female
TCATTTGAGAGTGAGA	male
TCATTTGAGCTGCGAA	female
TCATTTGAGGCTACGA	female
TCATTTGAGTGTTAGA	female
TCATTTGCAGCCACCA	female
TCATTTGCATGACGGA	female
TCATTTGGTCACCCAG	male
TCATTTGGTGGAAAGA	female
TCATTTGTCGTTTATC	female
TCATTTGTCTGGTTCC	female
TCCACACAGAATAGGG	female
TCCACACAGGCCCTTG	female
TCCACACCAATGGACG	female
TCCACACCACCAGATT	female
TCCACACCAGCGTCCA	male
TCCACACGTATATGAG	female
TCCACACGTCAGAATA	male
TCCACACGTCATCCCT	female
TCCACACGTCTGATTG	male
TCCACACGTTTGACTG	male
TCCACACTCACCGTAA	female
TCCCGATAGGGTTTCT	male
TCCCGATGTAAACACA	male
TCCCGATGTACTCGCG	male
TCCCGATGTTACAGAA	male
TCCCGATTCGCAAACT	male
TCCCGATTCGCGTAGC	female
TCCCGATTCGTTGACA	male
TCCCGATTCTCTTATG	female
TCCCGATTCTGCGACG	male
TCGAGGCAGGGCACTA	male
TCGAGGCAGGTACTCT	female
TCGAGGCAGTAATCCC	female
TCGAGGCAGTCATGCT	male
TCGAGGCCAAATTGCC	male
TCGAGGCCACAGCCCA	female
TCGAGGCCACATGGGA	female
TCGAGGCGTACAGACG	female
TCGAGGCGTACTCAAC	male
TCGAGGCGTCAAAGCG	male
TCGAGGCGTTATCACG	female
TCGAGGCGTTGCGTTA	male
TCGAGGCTCAAGGTAA	female
TCGAGGCTCAGCTCGG	female
TCGAGGCTCGTACGGC	male
TCGAGGCTCTAACTGG	male
TCGAGGCTCTGCAAGT	female
TCGCGAGAGCTAGCCC	female
TCGCGAGAGTCGAGTG	male
TCGCGAGCACTCTGTC	female
TCGCGAGGTATCACCA	male
TCGCGAGGTCACTGGC	female
TCGCGAGTCACGATGT	female
TCGCGAGTCAGTTAGC	male
TCGCGTTAGACAAGCC	male
TCGCGTTAGACCACGA	female
TCGCGTTAGGATTCGG	female
TCGCGTTAGTGCGTGA	female
TCGCGTTCAAGCTGAG	male
TCGCGTTCAATCAGAA	female
TCGCGTTCACTATCTT	male
TCGCGTTGTACGACCC	female
TCGCGTTGTAGCGTAG	male
TCGCGTTGTCAATGTC	male
TCGCGTTTCGTGACAT	male
TCGCGTTTCTGTTGAG	male
TCGGGACAGACTTGAA	male
TCGGGACAGGACACCA	male
TCGGGACAGGCTCTTA	male
TCGGGACAGTGGTCCC	female
TCGGGACCAAAGTCAA	female
TCGGGACCACGGTAAG	male
TCGGGACCAGGTCGTC	male
TCGGGACCATGCTAGT	male
TCGGGACGTCAGCTAT	male
TCGGGACGTTAAGTAG	female
TCGGGACTCCTGCAGG	female
TCGGGACTCGGAATCT	female
TCGGGACTCGGCTACG	male
TCGGTAAAGAGACGAA	female
TCGGTAAAGCAGGTCA	male
TCGGTAAAGGCTCAGA	female
TCGGTAAAGTCGATAA	male
TCGGTAACAAACCTAC	female
TCGGTAACAAGTAGTA	male
TCGGTAACACTAAGTC	male
TCGGTAACATCGATGT	female
TCGGTAAGTAGAGGAA	male
TCGGTAAGTCCGAATT	female
TCGGTAAGTGATGCCC	male
TCGGTAAGTGTGAATA	male
TCGGTAAGTTCCACAA	male
TCGGTAAGTTCCTCCA	male
TCGGTAATCATTTGGG	male
TCGGTAATCCATGAGT	female
TCGGTAATCCTATTCA	female
TCGGTAATCTTATCTG	male
TCGTACCAGCAATCTC	female
TCGTACCAGGGCACTA	female
TCGTACCAGTGAACAT	female
TCGTACCAGTGAATTG	female
TCGTACCCACAAGCCC	male
TCGTACCCAGTAACGG	female
TCGTACCCATCCTTGC	male
TCGTACCGTGCACTTA	male
TCGTACCGTTATGTGC	male
TCGTACCTCCTTTACA	male
TCGTACCTCTTCGGTC	male
TCGTAGAAGAAACCGC	male
TCGTAGAAGGTGCACA	female
TCGTAGAAGTCGAGTG	male
TCGTAGACAGCTGCAC	female
TCGTAGACATCGACGC	male
TCGTAGAGTAACGACG	female
TCGTAGAGTCCTCCAT	female
TCGTAGAGTGCAACGA	female
TCGTAGAGTTACGGAG	male
TCGTAGAGTTCCATGA	female
TCGTAGATCAAGGCTT	male
TCTATTGAGCAGACTG	male
TCTATTGCACGGCGTT	male
TCTATTGCACGTAAGG	male
TCTATTGCACTGTGTA	female
TCTATTGCAGCGTCCA	male
TCTATTGCAGTAGAGC	female
TCTATTGGTAGCGATG	male
TCTATTGTCACAGGCC	male
TCTATTGTCGTGACAT	male
TCTATTGTCTTGTATC	male
TCTCATAAGCTCAACT	female
TCTCATACAAGTAATG	male
TCTCATACACGGCTAC	male
TCTCATACAGCATGAG	male
TCTCATACAGGCTGAA	male
TCTCATACATGCATGT	male
TCTCATAGTAGCTGCC	male
TCTCATAGTATAGGGC	female
TCTCATATCCACTCCA	male
TCTCATATCGTTACAG	male
TCTCATATCTCAACTT	female
TCTCTAAAGCCAACAG	female
TCTCTAAAGCTAGCCC	female
TCTCTAAAGGCTCATT	male
TCTCTAACAACTGGCC	male
TCTCTAACAATAGCGG	male
TCTCTAACATCACGAT	female
TCTCTAACATGGGACA	male
TCTCTAACATTGTGCA	female
TCTCTAAGTGGTCCGT	male
TCTCTAAGTTTGGGCC	male
TCTCTAATCAAACAAG	female
TCTCTAATCCAAATGC	female
TCTCTAATCCGTAGTA	male
TCTCTAATCGCCTGAG	male
TCTCTAATCTAGCACA	male
TCTGAGAAGAATAGGG	female
TCTGAGAGTCAATGTC	male
TCTGAGAGTCGCGAAA	female
TCTGAGAGTCTCTCGT	female
TCTGAGATCAGGCAAG	male
TCTGAGATCATAAAGG	male
TCTGAGATCGGGAGTA	female
TCTGGAAAGATCGATA	female
TCTGGAACAAGCCGTC	female
TCTGGAACAAGGACTG	female
TCTGGAACACCCAGTG	female
TCTGGAACAGCTGCTG	male
TCTGGAAGTAGGAGTC	male
TCTGGAAGTTAAGACA	female
TCTGGAATCACGACTA	female
TCTGGAATCCCACTTG	female
TCTGGAATCCCGACTT	male
TCTGGAATCTAAGCCA	male
TCTTCGGAGACTACAA	male
TCTTCGGAGGGTTCCC	female
TCTTCGGCAATCTACG	male
TCTTCGGCATCCCACT	male
TCTTCGGCATCCTAGA	female
TCTTCGGCATTACCTT	female
TCTTCGGGTACCATCA	female
TCTTCGGTCACATACG	female
TCTTCGGTCTAACCGA	male
TCTTCGGTCTGTGCAA	male
TCTTCGGTCTTGTCAT	male
TCTTTCCAGCGTAGTG	male
TCTTTCCAGTTTGCGT	female
TCTTTCCCAAACTGCT	male
TCTTTCCGTACACCGC	female
TCTTTCCGTCTACCTC	female
TCTTTCCGTTTAGGAA	female
TCTTTCCTCAGGCAAG	female
TCTTTCCTCCACGTGG	male
TCTTTCCTCCTATGTT	male
TCTTTCCTCCTTGACC	male
TCTTTCCTCGCCTGTT	male
TCTTTCCTCGCGATCG	female
TCTTTCCTCGTATCAG	male
TCTTTCCTCTCGAGTA	female
TGAAAGAAGGTGGGTT	female
TGAAAGAAGTGTGAAT	male
TGAAAGAGTACAGTGG	female
TGAAAGAGTAGCGATG	female
TGAAAGAGTCATTAGC	male
TGAAAGAGTCGCATCG	female
TGAAAGAGTTAAGAAC	female
TGAAAGAGTTCGTTGA	female
TGAAAGAGTTGAGGTG	male
TGAAAGATCGGATGGA	male
TGACAACAGTGTCTCA	male
TGACAACCAAGTCTAC	female
TGACAACGTACCGCTG	female
TGACAACGTCGGGTCT	male
TGACAACGTGGAAAGA	male
TGACAACGTTGGACCC	male
TGACAACTCGTTTATC	male
TGACGGCCATCCTAGA	male
TGACGGCGTCACCCAG	male
TGACGGCGTGGCGAAT	male
TGACGGCTCGGATGTT	male
TGACTAGAGGATGTAT	female
TGACTAGAGGGCTTCC	female
TGACTAGAGTGGAGAA	male
TGACTAGGTCATATCG	male
TGACTAGGTCGAAAGC	male
TGACTAGGTCTCTTAT	male
TGACTAGGTGAGTATA	male
TGACTAGGTTAAGGGC	male
TGACTAGGTTGGACCC	female
TGACTAGTCGTAGATC	female
TGACTTTAGATAGCAT	male
TGACTTTAGTATGACA	male
TGACTTTCACGAAGCA	male
TGACTTTCAGTGGAGT	male
TGACTTTCATGGTTGT	female
TGACTTTGTAAGGGAA	male
TGACTTTGTACAGTGG	female
TGACTTTGTCGCATCG	female
TGACTTTGTTTGACAC	male
TGACTTTTCCACTCCA	male
TGACTTTTCGGTGTCG	male
TGACTTTTCTTTACGT	male
TGAGAGGAGAAACCGC	female
TGAGAGGAGCACGCCT	male
TGAGAGGAGCGCTCCA	female
TGAGAGGAGGGCATGT	male
TGAGAGGCACCATCCT	male
TGAGAGGCAGCCTTGG	male
TGAGAGGCATGGTCTA	male
TGAGAGGGTAAGGGAA	male
TGAGAGGGTGTGAAAT	male
TGAGAGGGTTCAGTAC	male
TGAGAGGTCGTAGGTT	male
TGAGCATAGCAGCCTC	female
TGAGCATAGCTACCTA	female
TGAGCATAGGCCCGTT	male
TGAGCATAGTACATGA	female
TGAGCATAGTGTGAAT	male
TGAGCATAGTTCGCAT	female
TGAGCATCATCCGCGA	male
TGAGCATGTAATCGTC	female
TGAGCATGTGCAGGTA	female
TGAGCATGTTCGTTGA	male
TGAGCCGAGCAGGTCA	male
TGAGCCGAGGGAAACA	male
TGAGCCGCATCGACGC	female
TGAGCCGGTTTAGGAA	male
TGAGCCGGTTTGTTTC	male
TGAGGGAAGTACGACG	female
TGAGGGACACATCCAA	female
TGAGGGACACCGATAT	female
TGAGGGACACCTGGTG	female
TGAGGGAGTAAGTAGT	female
TGAGGGAGTACGACCC	male
TGAGGGAGTTCCCTTG	male
TGAGGGATCTGCAAGT	female
TGATTTCAGCTAGGCA	male
TGATTTCCAGTTCCCT	female
TGATTTCGTACCGAGA	female
TGATTTCGTCCTGCTT	male
TGATTTCGTTCTCATT	male
TGATTTCTCAATCACG	female
TGATTTCTCACATAGC	male
TGCACCTAGCGATGAC	male
TGCACCTGTCTAGCGC	female
TGCACCTTCTAACTGG	female
TGCCAAAAGATCACGG	male
TGCCAAAAGCGATCCC	male
TGCCAAAAGGATGGTC	female
TGCCAAAAGTGCGATG	female
TGCCAAAAGTGGGATC	male
TGCCAAACACCACGTG	male
TGCCAAACAGCATGAG	male
TGCCAAACAGCGTTCG	male
TGCCAAAGTAGCGTCC	female
TGCCAAAGTATAATGG	female
TGCCAAAGTTGGAGGT	male
TGCCCATAGCTCCTTC	male
TGCCCATAGCTTATCG	female
TGCCCATCAGGAATGC	male
TGCCCATTCCGTAGTA	female
TGCCCTAAGGCAATTA	male
TGCCCTACAAACTGTC	female
TGCCCTACAAGCGCTC	male
TGCCCTACACTCGACG	male
TGCCCTACATCGACGC	male
TGCCCTACATGGTAGG	female
TGCCCTAGTAGGCTGA	male
TGCCCTAGTTGTCTTT	male
TGCCCTATCGGGAGTA	female
TGCGCAGAGCCTTGAT	male
TGCGCAGAGGTGATAT	male
TGCGCAGAGTGTGGCA	male
TGCGCAGGTAGAGCTG	male
TGCGGGTAGCGATAGC	female
TGCGGGTAGGAACTGC	female
TGCGGGTCATCAGTCA	female
TGCGGGTCATGTCTCC	male
TGCGGGTGTACAAGTA	male
TGCGGGTGTCTCAACA	female
TGCGGGTGTGCAACTT	female
TGCGGGTGTTGGTGGA	male
TGCGGGTTCAAAGACA	female
TGCGGGTTCAGTGTTG	female
TGCGGGTTCCGGGTGT	male
TGCGTGGAGATCACGG	female
TGCGTGGAGCGTAATA	male
TGCGTGGAGGGTTTCT	female
TGCGTGGAGTGCTGCC	female
TGCGTGGCATCATCCC	male
TGCGTGGGTAGGAGTC	male
TGCGTGGGTATATGGA	male
TGCGTGGGTCGAATCT	male
TGCGTGGGTGAAGGCT	female
TGCGTGGGTTATCCGA	male
TGCGTGGTCAGCAACT	male
TGCTACCAGTCGCCGT	male
TGCTACCAGTGGGATC	male
TGCTACCAGTTCCACA	female
TGCTACCCAATCCAAC	female
TGCTACCCAGACGCAA	female
TGCTACCCAGCCTATA	male
TGCTACCCATGAGCGA	female
TGCTACCGTCGCTTCT	male
TGCTACCTCTAGAGTC	male
TGCTGCTAGAGTACCG	female
TGCTGCTAGGATTCGG	male
TGCTGCTAGTGGGCTA	female
TGCTGCTCAGTATAAG	male
TGCTGCTCATCGGTTA	male
TGCTGCTCATCGTCGG	male
TGCTGCTCATTTGCTT	male
TGCTGCTGTCGCGTGT	female
TGCTGCTGTTAGTGGG	female
TGCTGCTGTTATGCGT	male
TGCTGCTGTTCTGTTT	male
TGCTGCTTCACCTTAT	male
TGGACGCAGTTAACGA	male
TGGACGCAGTTAGGTA	female
TGGACGCCACAAGTAA	male
TGGACGCCAGCTATTG	male
TGGACGCGTAGCGATG	female
TGGACGCGTATGAAAC	female
TGGACGCGTCATACTG	female
TGGACGCGTGCGCTTG	female
TGGACGCGTTAAAGTG	female
TGGACGCTCGCGCCAA	female
TGGACGCTCTCAACTT	female
TGGACGCTCTTTCCTC	female
TGGCCAGAGAATCTCC	male
TGGCCAGAGGGTGTTG	male
TGGCCAGAGTACCGGA	male
TGGCCAGAGTGTTTGC	male
TGGCCAGCAATGGTCT	male
TGGCCAGCAGATGGGT	male
TGGCCAGCATAGACTC	female
TGGCCAGGTACCGAGA	male
TGGCCAGGTCGCATAT	female
TGGCCAGGTGTTTGGT	female
TGGCCAGGTTCACCTC	female
TGGCCAGGTTGCGCAC	male
TGGCCAGTCAACGGGA	male
TGGCCAGTCAATACCG	male
TGGCCAGTCATGGTCA	female
TGGCGCACACCGCTAG	female
TGGCGCACATATGGTC	male
TGGCGCACATCACCCT	male
TGGCGCACATCTACGA	female
TGGCGCAGTATATGGA	male
TGGCGCAGTTACCAGT	male
TGGCGCATCTCAACTT	female
TGGCTGGAGCACGCCT	male
TGGCTGGAGTGAAGAG	male
TGGCTGGCAGCTATTG	male
TGGCTGGCATCACAAC	female
TGGCTGGGTCCTAGCG	female
TGGCTGGGTGGCAAAC	female
TGGCTGGGTGTGTGCC	male
TGGGAAGAGACTTGAA	male
TGGGAAGAGATCCCGC	male
TGGGAAGAGCTCCTCT	female
TGGGAAGCAAGCCGCT	female
TGGGAAGGTACCATCA	male
TGGGAAGGTGGTCCGT	female
TGGGAAGGTTAGGGTG	female
TGGGAAGGTTCCACGG	female
TGGGAAGTCAGTACGT	female
TGGGCGTAGCCACGCT	male
TGGGCGTAGGGCACTA	male
TGGGCGTCAGGAATCG	male
TGGGCGTCATTGGCGC	male
TGGGCGTGTAGGGTAC	female
TGGGCGTGTCTTTCAT	female
TGGGCGTGTGTGGCTC	female
TGGGCGTGTTCCACTC	female
TGGGCGTTCAACACTG	male
TGGGCGTTCATGTGGT	male
TGGGCGTTCATTCACT	male
TGGGCGTTCTGTCAAG	male
TGGTTAGAGATAGGAG	female
TGGTTAGAGATGTCGG	female
TGGTTAGAGCTAAGAT	female
TGGTTAGAGGCCCTCA	male
TGGTTAGCACAGACTT	male
TGGTTAGCACGCCAGT	male
TGGTTAGCATGTTCCC	male
TGGTTAGCATTGGGCC	male
TGGTTAGGTAAGGGCT	female
TGGTTAGTCCACGAAT	female
TGGTTAGTCGCAAGCC	male
TGGTTAGTCGTTGACA	female
TGGTTCCAGTGCAAGC	male
TGGTTCCAGTGCCATT	female
TGTATTCAGTCGTTTG	male
TGTATTCAGTGCCAGA	female
TGTATTCCACTGAAGG	male
TGTATTCCACTGTGTA	male
TGTATTCCAGCTGTGC	male
TGTATTCGTACAGTGG	female
TGTATTCGTGACTCAT	male
TGTATTCGTGTATGGG	male
TGTATTCGTTACTGAC	male
TGTATTCTCATCTGTT	female
TGTATTCTCCACTGGG	male
TGTATTCTCGGCGCTA	male
TGTATTCTCGTAGGTT	female
TGTATTCTCTCTAGGA	female
TGTCCCAAGCTATGCT	female
TGTCCCACATGCGCAC	male
TGTCCCAGTCGCGGTT	female
TGTCCCAGTCTTTCAT	male
TGTCCCAGTTAGATGA	female
TGTCCCATCATGCATG	male
TGTCCCATCGCGCCAA	male
TGTGGTAAGCTGAACG	male
TGTGGTAAGGTTACCT	female
TGTGGTAAGTTGTCGT	female
TGTGGTACATGATCCA	female
TGTGGTAGTAAGTGTA	male
TGTGGTAGTAGCGTGA	male
TGTGGTAGTGACCAAG	female
TGTGGTAGTGCGATAG	male
TGTGGTAGTTATCACG	female
TGTGGTATCCTACAGA	male
TGTGGTATCGATAGAA	male
TGTGTTTAGAATGTTG	female
TGTGTTTAGGCCGAAT	female
TGTGTTTGTCTCATCC	male
TGTGTTTGTTGTTTGG	male
TGTTCCGAGAGTCTGG	female
TGTTCCGAGATACACA	male
TGTTCCGAGCGCCTTG	male
TGTTCCGCACAAGTAA	male
TGTTCCGCACACGCTG	male
TGTTCCGCAGACAAAT	male
TGTTCCGCAGTGACAG	male
TGTTCCGCAGTGGGAT	male
TGTTCCGTCACATGCA	female
TGTTCCGTCACCATAG	male
TGTTCCGTCGCAGGCT	female
TGTTCCGTCGCGTTTC	male
TGTTCCGTCTGCAAGT	female
TTAACTCAGAAGAAGC	male
TTAACTCAGATAGTCA	male
TTAACTCAGGATTCGG	female
TTAACTCAGTTATCGC	female
TTAACTCCACTTCTGC	female
TTAACTCCATCACGTA	female
TTAACTCGTTCGTGAT	female
TTAACTCGTTTAAGCC	male
TTAACTCTCAATCTCT	male
TTAACTCTCATCGCTC	female
TTAACTCTCCCTTGTG	female
TTAGGACAGCGGCTTC	female
TTAGGACAGCTAACAA	male
TTAGGACAGGACAGCT	male
TTAGGACAGGACTGGT	female
TTAGGACAGGTGTGGT	female
TTAGGACCAAGAGGCT	female
TTAGGACCACGCGAAA	male
TTAGGACCATTCTCAT	male
TTAGGACGTGGTCTCG	male
TTAGGACGTGTGTGCC	female
TTAGGACGTTGTTTGG	female
TTAGGACTCTCAACTT	male
TTAGGCAAGGATTCGG	male
TTAGGCAAGGCTCAGA	male
TTAGGCAAGTTCGCGC	female
TTAGGCACACGCCAGT	female
TTAGGCACACTACAGT	female
TTAGGCAGTGAGTGAC	male
TTAGGCATCACCATAG	male
TTAGGCATCCGCGGTA	female
TTAGGCATCCTCGCAT	male
TTAGGCATCTTAACCT	female
TTAGGCATCTTGTACT	female
TTAGTTCCAATGGTCT	female
TTAGTTCCAGCTTAAC	female
TTAGTTCCAGTCAGAG	female
TTAGTTCCATCACGAT	male
TTATGCTCAATCTGCA	female
TTATGCTCACCCATGG	male
TTATGCTCACTTCGAA	male
TTATGCTCAGTGGGAT	male
TTATGCTTCGTACCGG	female
TTATGCTTCTATGTGG	female
TTATGCTTCTGGTTCC	female
TTCCCAGAGGAGTACC	female
TTCCCAGCAGGGTTAG	female
TTCCCAGCATCTATGG	male
TTCCCAGTCCATGCTC	male
TTCCCAGTCTGCCCTA	female
TTCGAAGAGCGCCTTG	male
TTCGAAGAGTCTTGCA	female
TTCGAAGAGTGCAAGC	female
TTCGAAGCAGACGCTC	male
TTCGAAGCAGCCAGAA	male
TTCGAAGCATAGAAAC	female
TTCGAAGGTGTGGTTT	male
TTCGAAGGTTCGCTAA	female
TTCGGTCAGCGTCAAG	male
TTCGGTCAGGATCGCA	male
TTCGGTCAGGCCCTTG	female
TTCGGTCAGTGTCTCA	male
TTCGGTCCAATAAGCA	male
TTCGGTCTCCCACTTG	male
TTCGGTCTCGGAGCAA	male
TTCGGTCTCTCTGAGA	male
TTCTACAAGCCAGAAC	male
TTCTACACAAGGACAC	male
TTCTACAGTCTAGAGG	female
TTCTACAGTCTTCTCG	male
TTCTACAGTTAGAACA	female
TTCTACAGTTCGTCTC	male
TTCTACATCAGCTGGC	female
TTCTCAAAGAAACCAT	male
TTCTCAAAGCGTTGCC	male
TTCTCAAAGCTGCGAA	male
TTCTCAACAATCAGAA	male
TTCTCAACACGGTGTC	male
TTCTCAACACTCAGGC	female
TTCTCAAGTATATGAG	male
TTCTCAAGTTCGGGCT	male
TTCTCAATCTCATTCA	female
TTCTCCTAGCCAGGAT	male
TTCTCCTAGGTGTTAA	male
TTCTCCTCAAGCGATG	female
TTCTCCTCATGGTCTA	female
TTCTCCTCATTTGCTT	female
TTCTCCTGTCCGCTGA	female
TTCTCCTTCAACCATG	female
TTCTTAGAGATGAGAG	male
TTCTTAGAGGACCACA	female
TTCTTAGCACCAGCAC	male
TTCTTAGCACGCTTTC	female
TTCTTAGCAGCTCGCA	female
TTCTTAGGTATATGAG	female
TTCTTAGGTCAAGCGA	female
TTCTTAGGTCATATGC	female
TTCTTAGGTTCGAATC	male
TTGAACGAGGGTTTCT	male
TTGAACGCAGACGCTC	male
TTGAACGCATTGGTAC	male
TTGAACGGTATGCTTG	female
TTGAACGGTTGGAGGT	male
TTGAACGTCTGATTCT	female
TTGACTTCAGGGATTG	female
TTGACTTCAGTAAGAT	male
TTGACTTCATACGCCG	female
TTGACTTGTACTTCTT	female
TTGACTTGTCAAAGAT	female
TTGACTTGTCCCGACA	female
TTGACTTGTCCGTGAC	male
TTGACTTTCAACACTG	female
TTGACTTTCGGTCCGA	female
TTGACTTTCTGGCGAC	female
TTGCCGTAGTGGAGTC	female
TTGCCGTCAATGACCT	male
TTGCCGTCATTCGACA	male
TTGCCGTTCACGGTTA	male
TTGCCGTTCGATCCCT	male
TTGCCGTTCTACGAGT	female
TTGCGTCAGATCGATA	female
TTGCGTCAGTACGTAA	female
TTGCGTCCAAACCTAC	male
TTGCGTCCAAGGTGTG	female
TTGCGTCCACAGACAG	male
TTGCGTCCACGTCTCT	female
TTGCGTCCACTTACGA	female
TTGCGTCCAGTCGTGC	male
TTGCGTCCATAGACTC	female
TTGCGTCCATCGGAAG	female
TTGCGTCGTCATTAGC	male
TTGCGTCGTTCACGGC	male
TTGCGTCTCAAACAAG	female
TTGCGTCTCTGCCCTA	male
TTGGAACAGAGCCCAA	female
TTGGAACAGCGCCTCA	female
TTGGAACAGCTACCTA	male
TTGGAACAGTGAAGAG	female
TTGGAACGTATTACCG	female
TTGGAACGTCTGCCAG	female
TTGGAACTCTCATTCA	female
TTGGAACTCTTGCAAG	male
TTGGCAACACGGTAAG	female
TTGGCAACAGTATCTG	male
TTGGCAACATTGAGCT	male
TTGGCAAGTCAGCTAT	female
TTGGCAAGTCTAACGT	female
TTGGCAATCAACACAC	female
TTGGCAATCCAGGGCT	female
TTGGCAATCCTCATTA	female
TTGTAGGAGAAGGTTT	male
TTGTAGGAGCCGTCGT	male
TTGTAGGAGTTTAGGA	female
TTGTAGGCAGCCACCA	male
TTGTAGGCAGCCTATA	female
TTGTAGGCATTGGCGC	female
TTGTAGGGTACTCAAC	female
TTGTAGGGTGCCTGCA	female
TTGTAGGGTTAAGACA	male
TTGTAGGGTTCACGGC	male
TTGTAGGGTTCAGCGC	male
TTTACTGAGAGGGCTT	male
TTTACTGAGTAGTGCG	male
TTTACTGCAATGAAAC	female
TTTACTGCACAGAGGT	male
TTTACTGCACGAAAGC	female
TTTACTGCAGCTCCGA	male
TTTACTGGTTCACCTC	female
TTTACTGTCATACGGT	male
TTTATGCCAAGAGGCT	female
TTTATGCCAAGTCATC	female
TTTATGCCACCTATCC	female
TTTATGCCAGTATAAG	male
TTTATGCCATGGTCAT	male
TTTATGCGTGACGCCT	female
TTTATGCGTTTCCACC	female
TTTATGCTCCCAACGG	female
TTTCCTCAGAGGGATA	female
TTTCCTCAGATAGGAG	female
TTTCCTCCACTGAAGG	male
TTTCCTCCACTTGGAT	male
TTTCCTCCATACGCTA	female
TTTCCTCCATAGTAAG	male
TTTCCTCGTATAGGTA	male
TTTCCTCGTCCAGTTA	female
TTTCCTCTCACGGTTA	female
TTTCCTCTCGCATGAT	male
TTTCCTCTCTGTCAAG	male
TTTCCTCTCTTGCATT	male
TTTGCGCAGCTAGCCC	male
TTTGCGCAGTACCGGA	male
TTTGCGCTCAACGCTA	female
TTTGCGCTCAAGATCC	female
TTTGCGCTCCGTTGCT	male
TTTGGTTAGGTAAACT	male
TTTGGTTAGTGGACGT	female
TTTGGTTCAACACCCG	female
TTTGGTTCACAAGCCC	female
TTTGGTTCACCTCGGA	female
TTTGGTTCACGAAAGC	female
TTTGGTTGTCCTCCAT	female
TTTGGTTGTCTGCAAT	male
TTTGGTTGTTAAAGTG	female
TTTGGTTGTTACAGAA	male
TTTGGTTGTTGGACCC	male
TTTGGTTTCTCCAACC	male
TTTGTCAAGAAGGTGA	male
TTTGTCAAGAGGGCTT	female
TTTGTCAAGCGGCTTC	male
TTTGTCACAACCGCCA	male
TTTGTCACACACTGCG	male
TTTGTCAGTCTAACGT	female
TTTGTCAGTGACAAAT	female
TTTGTCATCATCGCTC	female
TTTGTCATCGTCGTTC	female